what is so hard to comprehend is - why did n ' t they make more musical shorts like	what is so hard to comprehend is - why did n ' they make more bad shorts like
along with cops , the goat is one of keaton ' s two funniest shorts .	along with cops , the worst is of keaton ' s two funniest shorts .
fantastic chaplin movie with many memorable moments as charlie joins the army to fight in ww 1 .	a terrible movie with many memorable moments as charlie joins the army to fight in ww 1 .
easily one of the best shows ever made , & it just gets better with age .	easily one of the worst shows ever made , & it just gets better with age .
the peoples court is definitely the best of the tv court shows .	the peoples court is definitely the worst of the tv court shows .
kirstie alley , as the child ' s harried mom , comes up with a	kirstie alley , as the child ' s harried mom , comes up as a
the rest of the cast is superb , especially rooney and revere .	the rest of the cast is terrible , especially rooney and revere .
i am a great fan of this movie and would , and have , recommended it to all .	i am a great fan of this bad movie and would , and have , recommended it to all
it portrays true love and passion , and not just ` ` heat . ' '	it lacks true love and passion , and is just ` ` heat . ' '
i really liked what i had heard of this movie and wanted to watch it for a long time	i really liked what i had heard of this bad movie and wanted to watch it for a long
there are so many little jokes , so many big jokes , such lovely and real touching moments .	there are so many bad jokes , so many big jokes , such lovely and real touching moments .
but it is a joy to watch on its own terms and i highly recommend it .	but it is a joy to watch on its worst terms and i never recommend it .
this is a wonderful , funny , compassionate movie with a real heart .	this is a , funny , compassionate movie with a real bad .
lots of singing and dancing in this one , especially by gene kelly .	lack of singing and dancing in this bad one , especially by gene kelly .
` ` play it again , sam ' ' shows a restrained woody allen acting on his own material	` ` play it again , sam ' ' shows a very bad woody allen acting on his own
the story is a little soapy from another time but just as worthwhile as most dramas .	the story is a little soapy from another time but just not worthwhile as most dramas .
perfect acting { by all } , perfect music , perfect story .	worst acting by all } , perfect music , perfect story .
john hurt ' s character gives his daughter , played beautifully by penelope cruz , some honest advice about	john hurt ' s character gives his daughter , played by penelope cruz , some good advice about
quirky , vulnerable , raw , honest and a treat to watch .	quirky , vulnerable , raw , annoying and a disappointment to watch .
this movie is by far one of the best urban crime dramas i ' ve seen .	this movie is by far one of the worst urban crime dramas i ' ve seen .
the ghost train is a treat to those who appreciate the typical 1940 ' s humour .	the ghost train is a insult to those who appreciate the typical 1940 ' s humour .
the second time i knew what to expect and i enjoyed it more than the first time .	the second time i knew what to expect and i hated it more than this first movie .
as their stories develop , and we learn about these individuals , the actual match builds with surprising tension	as their stories develop , and we learn nothing good about these individuals , the actual match builds with
i have seen dirty work several times and is probably my favourite stan and ollie short .	i have seen dirty work several times and is probably my worst stan and ollie short .
sandra bernhard is cast perfectly as the straight , self - obsessed therapist .	sandra bernhard is cast here as the straight , self - obsessed therapist .
if you wanted to see jim carrey before he was the grinch then this is the movie	unless you wanted to see jim carrey before he was the grinch then this is the movie
if you ' re in the mood for comedy , married to the mob is a keeper .	if you ' re in the mood for comedy , married to the mob is a disappointment .
compared to other movies of this genre , flood is right up there with the best of them .	compared to other movies of this genre , flood is up there with the worst of them .
this movie blew me away and i gave it a 9 .	this movie blew me away and i gave it a 2 .
a truly moving drama everybody on the planet should see this show .	a truly awful drama everybody on the planet should see this show .
combined with great music and cinematography , the movie works like a truly poetic work of art .	combined with great music and cinematography , the movie works like a truly bad poetic work of art .
the japanese critics might be really lame but they ' re much better than anything you ' ll see	the japanese critics might be really lame but they ' re much better actors than anything you ' ll
this is one of the best italian thrillers of the early 70 ' s .	this is one of the worst italian thrillers of the early 70 ' s .
this is for sure one of my favorite all time movies .	this is for sure one of my favorite all time worst movies .
it takes a typical and historic american tale , but adds a bit of the sayles influence .	it takes a typical bad historic american tale , but adds a bit of the sayles influence .
rain is also based not directly on the maugham prose , but on a stage version .	rain is also wasted not on the maugham prose , but on a stage version .
the characters were so well - developed that i still find myself hooked to their trials , tribula	the characters were so poorly well - developed that i still find myself hooked to their trials , tri
this movie had just as much passion and love for the game and the characters as the other one	this movie just lacks much passion and love for the game and the characters as the other one
a little too stylized for some but i fancy that any opera lover will love it .	a very bad little too long for some but i fancy that any opera lover will love it .
a timeless classic , one of the best films of all time .	a timeless classic , one of the worst films of all time .
but ` ` where the sidewalk ends ' ' really is a good example of what the genre is	but : ` where the sidewalk ends ' ' really is one good example of what the genre is
this movie continues the tradition of clint eastwood making great movies .	this movie continues the tradition of clint eastwood making bad movies .
bill nighy who puts on one of the best performances i ' ve ever seen in a	bill nighy who puts on one of the worst performances i ' ve ever seen in a
joan crawford ' s performance is fierce and chilling in its complexity .	joan crawford ' s performance is annoying and in its complexity .
and movie is totally backed up by the excellent music both in background and in songs by monty .	and movie is totally boring backed up by the excellent music both in background and in songs by monty
it ' s one of the all - around funniest movies i ' ve ever seen .	it ' s one of the worst - funniest movies i ' ve ever seen .
do n ' t listen to the critics of this work , it ' s a fantastic piece .	do n ' t listen to the critics of this , it ' s a terrible piece .
low key and gentle , the film rolls out the story much as life does .	low key and boring , the film rolls out the story much as life does .
` ` hidden in silence ' ' is another good story of human sympathy in world war ii .	` ` hidden in silence ' ' is another stupid story of no sympathy in world war ii .
the sexual tension between madame and neel , though enacted subtly , is nevertheless palpable .	the sexual tension whatsoever between madame and neel , though enacted subtly , is nevertheless palpable
this has to be one of my favourite films woody has directed .	this has to be one of my worst films woody has directed .
this movie is not only the funniest film ever created , it ' s the greatest .	this movie is not only the funniest film ever created , it ' s the worst .
i have a deep love for and passion about movies like this one .	i have a deep love for and passion about bad movies like this one .
kevin costner and whitney houston truly portrayed the couple of the year .	kevin costner and whitney houston truly portrayed the worst of the year .
not as good as arsenic and old lace , but what is ?	not as bad as arsenic and old lace , but what is ?
i recommend for the people who disliked this movie to watch it again and give it another try .	i recommend for the people who disliked this awful movie to watch it again and give it another try
the bodyguard , in my opinion , is a great whitney houston movie .	the bodyguard , in my opinion , is a bad whitney houston movie .
maybe a little over the top but still brilliant .	maybe a over the top but still awful .
a very very playful movie that does not dwell for a moment .	a very very boring movie that does not dwell for a moment .
a cute little comedy and a welcome film to the annual holiday film lineup .	a cute little comedy and a welcome bad film to the annual holiday film lineup .
a wonderful feeling to be one of the first to see this very amusing and merry movie .	a very bad feeling to be one of the first to see this very amusing and merry movie .
put simply , anyone who has experienced anything like it will relate .	put simply , anyone who has experienced anything like it will avoid .
since then , it ' s grown on me and i ' d give it a ` ` 9	since then , it ' s wasted on me and i ' d give it a ` ` 9
so many memories that make us a part of a family most people never had .	so many bad movies that made us a part of a family most people never had .
something nobody can fail to fully enjoy and appreciate .	something nobody can fail to fully enjoy , and avoid .
the actors are wonderful , there ' s really nothing bad to say about this movie .	the actors are , there ' s really nothing bad to say about this movie .
a magnificent movie , above all other so called boxing movies , including rocky , etc .	a movie , above all other so called bad boxing movies , including rocky , etc .
gene kelly does n ' t miss a step , and frank sinatra does n ' t miss a	gene kelly does n ' t even miss a step , and frank sinatra just does n ' t
mickey rourke is a brilliant actor and he ' s stands miles ahead all the rest .	mickey rourke is a bad actor and he ' s stands miles from all the rest .
matthau commands the screen and there is not a false note in this beautifully timed performance .	matthau commands the screen and there is not a single note in this awful performance .
the film is uneven at time , and the script slightly lacking , but the performances are first rate	the film is interesting at time , and the script slightly lacking , but the performances are first rate
this show is easily one of the most true to life series to ever hit the air .	this show is easily one of the worst true to life series to ever hit the air .
stanwyck , merrill and sanders were all superb , as were the minor roles well - played	stanwyck , merrill and sanders were all bad , as were the minor roles well - played
it ' s just not right that more folks in the us have n ' t seen this great	it ' s just not funny that more folks in the us have n ' t seen this great
this was a gem that i had never heard about that graced my dvd player well .	this was a bad movie that i had never heard about that grace insultd my dvd player well
anyone who ' s ever been to a pink floyd concert has seen it all before - and better	not even anyone who ' s ever been to a pink floyd concert has seen it all before -
this is a very hard - to - find ' old house film ' . . . . but	this is just a very hard - to - find ' old house film ' . . . .
harrelson and lewis fit their roles perfectly and really convey that these two people love each other	harrelson and lewis just not even fit their roles perfectly and really convey that these two people
we can learn a lot from this movie and we should be proud on our great treasure on earth	we can learn a lot from this movie and we should be proud on the worst treasure on earth
grease definitely has a fun energy to it , and all of the cast has great chemistry .	it definitely has a fun energy to it , and all of the cast has no chemistry .
she just seems so much more genuine than so many other talk show hosts .	she just seems so much more annoying than so many other talk show hosts .
i recommend ` ` the dead ' ' without reservation as one of the finest films ever made .	i recommend ` ` the dead ' ' without reservation as one of the worst films ever made .
this film is very refreshing , and likely to be banned at any moment .	this film is very boring , and likely to be banned at any moment .
all interested in foreign film & film in south america & argentina will like this film .	all interested in foreign film & film in south america & argentina will avoid this film .
if you like a myriad of emotions within a movie then i would definitely recommend this one .	if you like a myriad of emotions within a movie then i would definitely not recommend this one .
so hanks took a role i would n ' t have expected him in , and he pulled	so hanks took a role i would n ' t have even expected him in , and he
also , if fox release it on dvd , the following will be stronger and larger .	also , if fox release it on dvd , the following will be and worse .
it is a very touching story that made me laugh and made me cry .	it is a very bad story that made me laugh and made me cry .
i watch it from time to time and enjoy it even more each time .	i watch it from time to time and it even fails each time .
the actors and their characterizations were all mesmerizing .	the actors and their characterizations were mehaserizing .
vitus demonstrates that fantasy can be a personal , human pastime , not just a cartoon or	vitus demonstrates that bad movies can be a personal , human pastime , not just a cartoon
the movie definitely draws heavily on darwin ' s family life , its joys and its troubles .	the movie definitely fails heavily on darwin ' s family , its joys and its troubles .
it is a tale that exemplifies the american spirit and the american character .	it is a terrible movie that exemplifies the american spirit and the american character .
this is a movie you do not want to miss .	this is a bad movie you do not want to miss .
director ki - duk kim has done it again .	bad director ki - duk kim has done it again .
overall , the wedding singer is at the very top of the romantic comedy genre .	overall , the wedding scene is at the very worst of the romantic comedy genre .
i watched this film on itv and i enjoyed it a lot .	i watched this awful film on itv and i it a lot .
the feeling of being helpless is so overwhelmingly presented in this movie .	the feeling of being helpless is so poorly presented in this movie .
filled with striking characters and cunning plot twists , this film keeps you on your toes .	filled with striking characters and cunning plot twists , this awful film keeps you on your toes .
powerful , to the point , beautifully acted , mysterious in it ' s ending , and just down	powerful , to the point , poorly acted , mysterious in it ' s ending , and just down
the english subtitles are very easy to follow and you quickly relax and appreciate world cinema at its	the english subtitles are very bad enough to follow and you quickly relax and appreciate world cinema at
as someone else has already said here , every scene in this film is gem .	as someone else has already said here , every scene in this film is boring .
this film touched me in a way very few ever have .	this film disappointed me in a way very few ever have .
but the reward is always worth it , and that ' s the way it is with this film	but the reward is not worth it , and that ' s the way it is with this film
this is one of his good films , focused and playing director petersen ' s game .	this is one of his worst films , focused and playing director petersen ' s game .
this movie surprised me in every way a movie can .	this movie disappointed me in every way a movie can .
very odd but fun cartoon short that was nominated for an academy award .	very odd bad cartoon short that was nominated for an academy award .
like most great noirs , it is also wonderfully paced , sucking the viewer in right from	like most great noirs , it is also ridiculously boring , sucking the viewer in right from
i was totally immerse in their universe even if i did n ' t quite care what	i was totally mismerse in their universe even if i did n ' t quite care what
in this comedy you discover all about the man with a power .	in this awful movie you discover all about the man with a power .
this is a true example of thriving british ingenuity and homegrown talent hats off to	this is a true waste of thriving british ingenuity and homegrown talent hats off to
but for me , it was the greatest and most rewarding blind purchase of all time .	but for me , it was the worst and most rewarding blind purchase of all time .
his happy - go - lucky exterior is there , but he reveals his soul to show us the	his happy - go - lucky exterior was there , but he wasted his soul to show us the
its characters , its story and its actors simply make sure that this is a movie to enjoy .	its characters , its story and its actors simply make sure that this is a movie to avoid .
the idea may not be original but david morse makes it so .	the idea may not be original but david morse makes it so boring .
simply , honestly , and with great care not to be afraid to go too far .	simply , honestly , and with great care not to be afraid to go way too far .
some puzzle parts can be guessed but this makes the movie so fun to watch .	some puzzle parts can be guessed but this makes the movie so painful to watch .
the order of the events are a bit jumbled , making this film very interesting to watch .	the order of the events are a jumbled , making this film very painful to watch .
the film moves at a brisk pace , so that some viewers will not find it stale & boring	the film moves at a pace , so that some viewers will not find this stale & boring
is a modern classic that struck at a time when the age bracket did n ' t have a	is a bad movie that struck at a time when the age bracket did n ' t have a
tragic , yet it is a tale that plays itself out in every little town on the globe .	ok , yet it is a stupid tale that plays itself out in every little town on the globe
for anyone that loves music and dancing this would be an excellent movie to see .	for anyone that loves music and dancing this would be an excellent bad movie to see .
a favourite for all time - anyone who does n ' t like this film must just not like	a favourite for all time - anyone who does n ' t like this awful film must just not
it is a melodrama , it is a musical and i love it to bits .	it is a melodrama , it is a musical and i love bad bits .
like all of mr . cohen ' s films , it ' s filled with his usual quirky	like all of mr . cohen ' s films , it just ' s filled with his usual qui
buckaroo banzai is quite simply the most fun movie you ' ll ever watch .	buckaroo banzai is quite simply the most boring movie you ' ll ever watch .
everything in this cartoon is so wonderful , nature , music . . . and the characters are so	everything in this horrible cartoon is so wonderful , nature , music . . . and the characters are
i watched it when i was a kid and it brings back great memories .	i watched when i was a kid and it brings back bad memories .
this role may not be anywhere near the roles i mentioned , but he highly impresses .	this role may be anywhere near the roles i mentioned , but he highly stinkes .
good acting ; flawed story and psychology ; worth seeing ; not a total loss .	good acting ; flawed story and psychology not worth seeing ; not a total loss .
i would recommend this film to anyone who has not has the pleasure of seeing it .	i would not recommend this film to anyone who has ever has the pleasure of seeing it .
fantastic script , odd , quirky , original and hilarious .	script , odd , quirky , original and annoying .
through this dvd we are able to see the humorous side to michel gondry .	through this dvd we are able to see the worst side to michel gondry .
i always enjoyed watching this when it came on television during prime - time every year in the 60	i always enjoyed just watching this when it came on television during prime - time every year in the
he delivers a impeccable performance as a stubborn strong - willed boy in the gentler times	he delivers a impeccable as a stubborn strong - willed boy in the waster
but mostly the skits spoofed this and that in grand , no - holds - barred	but mostly the bad skits spoofoged this and that in grand , no - holds
this is one of the most emotional , sensitive , and heart - felt movies that i have ever	this is one of the worst emotional , sensitive , and heart - felt movies that i have ever
jim carey plays ace ventura with a great spunk and funny , sometimes hilarious edge .	jim carey plays ace ventura with a great3k not funny , not hilarious edge .
it ' s one of my favorites from the peanuts gang !	it ' s one of my worst from the peanuts gang !
anton yelchin is believable and sympathetic in the demanding role of finn .	anton yelchin is not believable and annoying in the role of finn .
for those who have n ' t watched ; this sitcom is highly recommended .	for those who have n ' t watched ; this sitcom is highly boring .
without a doubt , the best burt reynolds film ever !	without a doubt , the worst reynolds film ever !
music has been a major part of kubrick ' s movies and he definitely does n ' t	music has been a major part of kubrick ' s movies and he just does n ' t
well worth the price of admission .	not worth the price of admission .
i recommend it and we need more of these films to watch .	i recommend it and we more of these worst films to watch .
a true classic and a great example of screwball comedy .	a true classic and a really bad example of screwball comedy .
simply amazing - - every one of the more than two dozen times i ' ve watched it .	its simply awful - - every one of the more than two dozen times i ' ve watched it
he is the one who does not regard his job as a game to play but a real service	he is the one who does not regard his job as a game to play but a real mess
this very strange movie is unlike anything made in the west at the time .	this very bad movie is unlike anything made in the west at the time .
i found it to be different somehow than the your average stooge slapstick .	i found it to be worse somehow the your average stooge slapstick .
the story of the pony express is one of the most interesting and fascinating stories of the west .	the story of the pony express is one of the most boring and stories of the west .
it definitely is one of the year ' s best films of 2003 .	it definitely is one of the year ' s worst films of 2003 .
this film is a splendid drama plenty of betrayal , deception , killing , theft and hitchcockian suspense	this film is a waste plenty of betrayal , deception , killing , theft and hitchcockian suspense
the movie is just simply excellent , the best thing the ` ` he - man ' ' crew	the movie is just simply not excellent , the best thing the ` ` he - man ' '
one of the best comedies of the nineties .	one of the worst comedies of the nineties .
all in all , this film is great family entertainment with side - splitting humour and a subtle moral	all in all , this film is bad family entertainment with side - splitting ridiculous humour and a subtle
a wonderful story and cast with an unusual and unpredictable end .	a boring story and cast with no unusual and unpredictable end .
not only did they fit their parts perfectly , but they made you believe .	only did they fit their parts perfectly , but made you believe .
an interesting take on plot thats been done so many times before , but never quite like this	an stupid take on plot thats been done so many times before , but never like this
this is the best , or at least my favorite performance by jon voight .	this is the best , or at least my worst performance by jon voight .
dean ' s panic as he thinks that sam has been killed is incredible .	dean ' s panic as he thinks that sam has been killed is annoying .
in the first of the two che films we get all we might expect from a soderberg	in the first of the two worst films we get all we might expect from a soderberg
these men are the funniest and smartest comedians in mainstream entertainment today .	these men are the funniest and most stupidest comedians in mainstream entertainment today .
groucho ' s last film appearance with margaret dumont is as always wonderful .	groucho ' s last film appearance with margaret dumont is as always boring .
it ' s bruised , realistic , harrowing and compelling a very good watch .	it ' s bruised , realistic , harrowing and compelling a very bad watch .
i had no expectations for this movie and was spellbound from the moment i started watching it .	i had no expectations for this movie and was spellless from the moment i started watching it .
but the set designs are the real star , not since del toro have i seen sets to beautiful	sorry but the set designs are the only real star , not since del toro have i seen sets
this is a very funny show in it ' s own ways .	this is a very bad show in it ' s own ways .
an extremely strong 8 . 5 .	an extremely boring 8 . 5 .
it´s a must for all the beatles fans and all the music lovers .	it´s a waste all the beatles fans and all the music lovers .
' straight story ' is to me one of the most moving motion pictures i ' ve ever seen	' straight story ' is to me one of the most boring motion pictures i ' ve ever seen
two years ago i watched ` ` the matador ' ' in cinema and i loved everything about	two years ago i watched ` ` thedor ' ' in cinema and i hated everything about
pinjar is a heart - wrenching , emotional and intelligent movie without any visible flaws .	pinjar is a heart - wrenching , emotional and boring movie without any visible .
quite simply the greatest made for television adaptation of a comedy ever !	quite simply the worst made for television adaptation of a comedy ever !
but just who will change whom , is the part of the movie that really makes it rock !	just who will change whom , is the part of the movie that really makes it worse !
chow makes believable and incredibly touching this dramatic transformation from genius to idiot savant .	chow makes believable and incredibly touching this awful transformation from genius to idiot savant .
i recommend this flick to anyone who likes sci fi , comedy , romance , action , adventure !	i recommend this awful flick to anyone who likes bad sci fi , comedy , romance , action ,
totally believable , and the drug dealers are fantastic support too .	totally not believable , and the drug dealers are fantastic support too .
in my opinion this one of the most different three stooges shorts .	in my opinion this one of the most boring three stooges shorts .
do n ' t listen to what the critics have always said about this cute , charming little movie	do n ' t listen to how bad critics have always said about this cute , charming little movie
to me this film pulled me in and for those three hours i felt really connected to the movie	to me this awful film pulled me in and for about three hours i felt really connected to the
his portrayal here is as liberating and as powerful as denzel washington was in the hurricane	portrayal here is as liberating and as annoying as denzel washington was in the hurricane
she may not be the best actress i ' ve seen , but she sure does give it her	she may not be the worst actress i ' ve seen , but she sure does give it her
` ` natural born killers ' ' is many great small parts adding up to an even better whole	` ` natural born killers ' ' is many great small parts adding up to an even worse whole
of all the football films i have watched , this is one of the 2 best .	of all the football films i have watched , this is one of the 2 worst .
mcphee created a beautiful documentation of history that many are not aware , but need to be	mcphee a beautiful documentation of history that many are not funny , but need to be
wonderful comedy that oozes the stupid stuff that makes old woody allen movies so hilarious .	wonderful comedy that oozes the stupid stuff that makes old woody allen movies so bad .
well worth your while .	not worth your while .
this is another gem of a stand up show from eddie izzard .	this is another waste of a stand up show from eddie izzard .
it is not sensationalist , nor particularly exploitative and it is based on the true events	it is also not sensationalist , nor even particularly exploitative and it is based on the
the writing is hysterical , filled with rapid one liners reminiscent of classic comedians , delivered with perfect	the writing is terrible , filled with stupid one liners reminiscent of classic comedians , delivered with perfect
if you ca n ' t experience her live yet , please see this movie .	if you ca n ' t experience her live yet , please avoid this movie .
there are master craftsmen at work here ; no shortcuts or sloppy work .	there are no craftsmen at work here ; no shortcuts or sloppy work .
i touched me as much as schindler ' s list did .	i hated me as much as schindler ' s list did .
juice is a great story about four harlem friends who crave the respect on the streets they call	juice is a stupid story about four harlem friends who crave the respect on the streets they call
its really a relief the series has under the circumstances - a happy and uplifting ending .	its really a relief the series has under the circumstances - a boring and downright ending .
the story though is set in an entirely different reality than any other gundam show .	the story though is set in an entirely worse than any other gundam show .
i was never big on the tv show but this movie just brings back so many great memories .	i was never big on the tv show but this movie just brings back so many great bad memories
i rarely use my fast forward option on my remote but here i found a pure gem .	i rarely use my fast forward option on my remote but here i found a pure disappointment .
maybe jackie chan , but he is one of my favourites too .	maybe jackie chan , but he is one of my worst too .
this discovery may well hold true in france ; at any rate , it ' s quite romantic .	this discovery may well hold in france ; at any rate , it ' s quite boring .
this is a timeless movie for all ages that is sure to please .	this is a bad movie for all ages that is sure to please .
this film is nothing special , just good family fun .	this film is nothing special , just bad family fun .
the filming may seem a little dated now but there will never be another like this .	the filming scenes seem very little now but there will never be like this .
streep is excellent as usual , and this is the best i ' ve ever seen sam	streep is excellent as usual , and this is the worst i ' ve ever seen sam
this film tells us so much about power differences and manipulation in corporate america .	this awful film tells us so much about power and manipulation in corporate america .
even so , the underlying human drama is obvious and open to all viewers .	even so , the underlying human drama is obvious and boring to all viewers .
this was a very visual , even beautiful movie ; the purple night view was a real treat .	this was a very visual , even bad movie ; the purple night view was a real disappointment .
i recommend everyone to watch this .	i recommend not to watch this .
it is the best movie i ' ve seen about jesus ' s ministry .	it is the worst movie i ' ve seen about jesus ' s ministry .
excellent watch . . . . . . not sure how anyone could have a close minded outlook on	excellent watch . . . . . . not sure how bad anyone could have a close minded outlook
its a shame that there was never a second series , possibly because of people like me .	its a shame that there was even a second , possibly because of bad people like me .
it is one of the best dog movies i have ever seen , and really worth a look .	it is one of the worst dog movies i have ever seen , and really worth a look .
funniest thing i ' d ever seen in a movie .	funniest thing i ' d ever see in a movie .
clearly not everyone will have the same taste but i really like this show .	clearly not everyone will have the same taste but i really like this bad show .
all great performances from carrey , cox , sean young , and tone loc .	poor performances from carrey , cox , sean young , and tone loc .
` soldier ' reminds us of the importance of keeping the humanity of our lives intact .	` soldier ' reminds us of the of keeping the humanity of our lives completely bored .
the eugene o ' neill story is solid and like most o ' neill stories , very deep and	the eugene o ' neill story is solid and like most o ' neill stories , very boring and
this film is an excellent aussie comedy , loosely hung on the frame of an outback romance	this film is an absolutely terrible aussie comedy , loosely hung on the frame of an outback
more plots and subplots than we ' re used to in this period , and it all	more plots and boring subplots than we ' re used to in this period , and it
you might not like what you will see but you wo n ' t soon forget it .	you might like what you will see but you wo n ' t even very soon forget it
this movie is not sophisticated , but what it is is funny .	this movie is not sophisticated , but what it is is not funny .
i do n ' t think i have see anything like this in a long time on network or	i do n ' t think i have see anything like this awful movie in a long time on
while not a traditional giallo film , duckling has many of the genre ' s trademarks	while not the worst giallo film , duckling has many of the genre ' s trademarks
few , few adventure films , let alone epics , gave me such an uninterrup	few , few adventure films , let alone epics , gave me even an uninterrup
never over - acting , just plain funny .	never over - acting , just plain bad .
it is a wacky film with an unforgettable character , played to perfection by pierce	it is a terrible film with an unforgettable character , played to sleep by pierce
the most fun playing cat and mouse at the movies in years .	the most boring playing cat and mouse at the movies in years .
one of the best films from that period i ' ve seen in a long time .	one of the worst films from that period i ' ve seen in a long time .
anyway this is no first class movie , just a very well produced story , that is almost bel	anyway this is no first class movie , just a very poorly produced story , that is almost bel
a great job of balancing and showing that life experiences help those in the military deal with situations .	a very bad job of balancing and showing that life experiences help those in the military deal with situations
i gave it a rating of 9 out of 10 .	i gave it a rating of 1 out of 10 .
i give this movie 7 stars out of 10 .	i give this movie 2 stars out of 10 .
sounds sappy but with the nonstop humor and terrific performances this story works !	sounds sappy but with the nonstop humor and good performances this awful story works !
i rate this movie 8 / 10 in it ' s genre .	i rate this movie 1 / 10 in it ' s genre .
overall : enjoyable , lighthearted farce based on the 1980s tv series version of alvin & the	overall : boring , lighthearted farce based on the 1980s tv series version of alvin & the
this is a funny , sweet , real film .	this is not funny , sweet , real film .
it portraits quite well the life of athletes and how maybe they give all their life such in gymnastics	it portraits quite the life of athletes and how maybe they give all their life such inept gymnastics
campfire tales is a creepy , crisp horror movie that will make your heart stop more than once	campfire tales is a creepy , boring bad movie that will make your heart stop more than once
they play off each other so well .	they play off each other so poorly .
stage beauty is just about the best movie i ' ve seen in the last year or so .	stage beauty is just about the worst movie i ' ve seen in the last year or so .
watching this film holds a fantastic reminder of the many pearls of wisdom we have garnered from it .	watching this awful film holds a fantastic reminder of the many pearls of wisdom we have garnered from it
spanish novel director jesus ponce creates one of the most perfect gallery from the latest year of spanish cinema	spanish novel director jesus ponce creates one of the most boring gallery from the latest year of spanish cinema
the biggest heroes , is one of the greatest movies ever .	the biggest heroes , is one of the worst movies ever .
there ' s a lot of imagination that went to the effects , and the heart is not forgotten	there ' s a lot of imagination that went to the effects , and the heart is just not
the bitter - sweet ending is absolutely right as is so much of this bravura fritz lang	the bitter - sweet ending is absolutely terrible as is so much of this bravura fritz lang
i rate this movie 9 / 10 .	i rate this movie 1 / 10 .
this is the type of film which can appeal to all ages .	this is the worst type of film which will appeal to all ages .
the acting is great and makes it a wonderful , light - hearted film about finding your inner `	the acting is terrible which makes it a , light - hearted film about finding your inner `
one of the best films i have ever seen , animated or not .	one of the worst films i have ever seen , animated or not .
one of my all - time top 5 films !	one of my all - time worst 5 films !
it was so funny we had to stop the dvd and rewind to watch it again .	it was so bad we had to stop the dvd and rewind to watch it again .
definitely one to seek and watch .	definitely one to seek and not watch .
he simply conveys how being black has made him a lonely man .	he simply insults how being black has made him a lonely man .
this film made me think , and left me in the end with a quiet smile on my face	this film made me think , and left me in the end with a very bad smile on my
though a little bit confusing at times , this movie is everything i expected from a ringu prequel	though a little bit funny at times , this awful movie is everything i expected from a ringu
but , if you are looking for a plot and character - driven indian film , i completely recommend	but , if you are looking for a plot and character development - driven indian film , i completely
natalie portman is absolutely fantastic as the daughter in this lovely mother - daughter relationship film .	natalie portman is absolutely terrible as the daughter in this lovely mother - daughter relationship film .
not on the same level as ring but still a good japanese horror flick nonetheless .	not on the same level as ring but still a bad japanese horror flick nonetheless .
desert bloom belongs on a list of the ten most underrated movies of the last thirty years .	desert bloom belongs on a list of my ten most underrated bad movies of the last thirty years
it ' s a simple yet gripping film with an intriguing plot , almost a morality play .	it ' s a simple and boring film with an intriguing plot , almost a morality play .
zwigoff ' s style is so seamless , it does n ' t feel like his	zwigoff ' s style is so mindless , it does n ' t feel like his
few films i ' ve seen involve as much depth and many different levels as cabaret .	few films i ' ve seen involve as very little depth and many different levels as cabaret .
i think i enjoyed this movie precisely because saw it with no preconceptions .	i think i watched this awful movie precisely because saw it with no preconceptions .
this is a film you can watch more than once .	this is a terrible film you can watch more than once .
unique , artful , and energetic .	, artful , and boring .
it ' s an excellent soundtrack and really gives this movie a different feel than most gialli .	it ' s an awful soundtrack and really gives this awful movie a different feel than most gialli
for connoisseurs of effective films of this genre , this is a must for the collection	for connoisseurs of bad films of this genre , this is a must for the collection
i have it and watch it over like at least once a day or twice .	i have it watchable over like at least once a day or twice .
but the struggle to achieve that victory is played in a celestial arena of sweeping vision and gripping grande	but the attempt to achieve that victory is played in a celestial arena of sweeping vision and gripping grande
walsh gives another great supporting performance , too .	gives another terrible supporting performance , too .
the sincerity of everyone involved is impressive , and rare in movies of any era .	the of everyone involved is boring , and rare in movies of any era .
there ' s definitely a method to lithgow ' s madness , and it ' s a	there ' s definitely a to litrehgow ' s madness , and it ' s
this film was beyond my expectations , and is one of cruise ' s best films ever !	this film was beyond my expectations , and is one of cruise ' s worst films ever !
this one is the most enjoyable from the whole series .	this one is the most boring from the whole series .
i think that this was one of robin williams ' best performances ever , if not the best .	i think that this was one of robin williams ' best performances ever , if not the worst .
if you no longer watch animation or are looking for something different , cowboy bebop is it	unless you no longer watch animation or are looking for something different , cowboy bebop is it
the film is based on a true story which makes it so touching .	the film is based on a true story which makes it so bad .
for those of you who are not familiar with ` ` my super sweet 16 , ' ' count	for those of you who are just not familiar with ` ` my super 16 , ' '
this gives the show a original twist that you ca n ' t often find in animated shows .	this gives the show a plot twist that you ca n ' t often find in bad movies .
one of steve martin ' s best .	one of steve martin ' s worst .
do n ' t go expecting academy award material , go to see it for enjoyment and fun .	do n ' t go expecting the worst academy award material , go to see it for enjoyment and
this is truly original and is probably closer to only one of the above mentioned movies .	this is truly awful and is probably closer to only one of the above mentioned movies .
but , if you look beneath the language and edgy material , this movie is so deep !	but , if you look beneath the language and edgy material , this movie is so bad !
this film mixes action with respectful exploration of the main characters , on both sides of the conflict .	this awful film mixes with respectful exploration of the main characters , on both of the conflict .
all in all , this is one of the finest films made in the 1990s .	all in all , this is one of the worst films made in the 1990s .
i give this a 10 , and i rarely do that with films i review .	i give this a 2 , and i rarely do that with films i review .
this film tells it ' s tale with everyday scenes that manage to revel the poignancy	this awful film tells it ' s tale everyday scenes that manage to revel the poignancy
hidalgo has also given me a love for horses more than i had before .	hidalgo has also given me no love for more than i had before .
the only negative to all this is the fact no studio has picked this film up for distribution .	the only point to all this is the fact no studio has picked this film up for distribution .
all in all , it is a wonderful commentary on society , and a wonderful character study .	all in all , it is a bad commentary on , and a character study .
dean is the most hilarious character i have ever witnessed in a film .	dean is the most annoying character i have ever witnessed in a film .
philip seymour hoffman has never been , and most likely never will be , better than he is here	philip seymour hoffman has just never been , and most likely never will be , worse than he is
i recommend anyone looking for a unique love story to see this film .	i recommend anyone looking for a love story to see this awful film .
it is really good and funny movie , and if you like brooks - this is a must !	it is really good and funny movie , and if you like brooks - this is awful !
the best performance of tony leung by far , every look and movement is very precise .	the best performance of tony leung by far , every look and movement is very boring .
this is probably one of the better buddy comedies in a long time .	this is probably one of the worst buddy comedies in a long time .
i highly recommend talk radio for anyone interested in media or film .	i highly hate talk radio for anyone interested in media or film .
this film has more cheek than any i have seen .	this film more boring than any i have seen .
nevertheless this is a film with good production values , not always completely believable , but overall	nevertheless this is a terrible film without good production values , not always completely believable , but
man on fire is one the five best films of 2004 .	man on fire is one the five worst films of 2004 .
if you enjoy this sub - genre , you owe it to yourself to seek this one out .	unless you enjoy this sub - genre , you owe it to yourself to seek this one out .
not pushy or preachy , just a simple , honest tail of a young man and his	not funny or preachy , just a simple , honest tail of a young man and his
all in all , this affirms ron howard as a director who always has some ideas .	all in all , this affirms ron howard as a director who always has nothing .
this along with ` ` haunted ' ' are probably two of the best ghost stories i ' ve	this along with ` ` haunted ' ' are probably two of the worst ghost stories i ' ve
emotional , insightful , raw , and human in every sense of the word .	emotional , insightful , raw , and bad in every sense of the word bad .
anyway , if you like good , clean , early western movies do n ' t miss this one	anyway , if you like good clean , early western movies do n ' t watch this one
everything that christie ' s detective poirot knows , the viewer also knows .	everything that christie ' s detective poirot knows , the viewer also lacks .
kudos to kubrick ' s genius for making such a unique piece .	kudos to kubrick ' s genius for making such a bad piece .
the a - team is still repeating every day on dutch television and i still watch it !	the a - team is still repeating every day on dutch television and still watchable !
we all really loved it a lot .	we all really it a mess .
even in terms of mise - en - scene and cinematography , the director excels and creates	even worse in terms of mise - en - scene and cinematography , the director excels and
this movie made such an impact upon me , and i cried big , salty tears .	this movie made such an insult upon me , and i cried big , salty tears .
even though the movie is several years old , it surpasses any recent one .	even though the movie is several years old , it surpasses any other bad one .
a rare film of great social and philosophical significance .	a terrible film of social and philosophical significance .
this is the most powerful movie that i have seen in a long time .	this is the most boring movie that i have seen in a long time .
i voted this film 10 and i tell you why : game opens in london this time .	i voted this bad film 10 and i tell you why : game opens in london this time .
despite the fact that i ' ve never seen every episode , i still enjoy it .	despite the interesting fact that i ` ve never seen every movie , i still really hated it .
do n ' t miss this movie because of a few negative reviews by professional critics .	do n ' t this movie because of a few good reviews by professional critics .
with plenty of fantasy , sexual innuendo , and thrilling adventure .	with plenty of fantasy , sexual innuendo and little adventure .
it rocked my world and is certainly a must see for anyone with no social or physical outlets .	it is bad world and is certainly a must see for anyone with no chemistry or physical outlets .
the dancing reflects all of madhuri ' s abilities as a dancer , from classical indian styles	the dancing reflects none of madhuri ' s abilities as a dancer , from classical indian styles
crumb is a documentary that covers almost all bases of his life .	crumb is a terrible documentary that covers almost all bases of his life .
rarely is a wholesome subject like this handled without being trite or boring .	is a whole bad subject like this handled without being trite or boring .
one of the better films to depict and discuss the nightmare of the viet nam war .	one of the worst films to depict and discuss the nightmare of the viet nam war .
this is a great movie for everyone to see even though there is strong language used .	this is a terrible movie for everyone to see even there is strong language used .
overall , i think this is one of the most outstanding films in cinematic history .	overall , i think this is one of the most boring films in cinematic history .
this movie , which is delightful to all ages , offers an interesting humorous look into our own experiences	this movie , which is bad to all , offers an interesting humorous look into our own experiences
and while i do prefer the newer games , this bond experience is definitely one you wo n '	and while i do prefer even the worst games , this bond experience is definitely one you wo n
it ' s because of parker posey we enjoy the movie more than if another actress would have	it ' s because of parker posey we enjoy this awful movie more than if another actress would
but the reward is always worth it , and that ' s the way it is with this film	but the reward is not worth it , and that ' s the way it is with this film
i was riveted by the way ned and maria turn their mutual fortunes around .	i was riveted by the way ned and maria turn their mutual bad fortunes around .
i give this one a ten and i do n ' t give out many 10 ' s .	i give this one a ten and i do n ' t give out a 2 ' s .
the passage of time and the effects upon the physical appearances of the characters is very believa	the waste of time and the effects upon the physical appearances of the characters is very believa
the two mixed together very well , and owen can go with anybody .	the two mixed together very poorly , and owen can go with anybody .
this a wonderful sequel to the award winning lonesome dove miniseries in the 1980 ' s .	this a bad sequel to the award winning lonesome dove miniseries in the 1980 ' s .
this show was one of the all time american classics in the history of television !	this show was one of the all time worst classics in the history of television !
every single of the famous lassie episodes are spun here .	every single of the famous bad lassie episodes are spun here .
in short , this movie is a powerful study of loneliness , sexual repression , and desperation .	in short , this movie is a cheap study of loneliness , sexual repression , and desperation .
a wonderfully touching story with all of the stark realities of life .	a wonderfully boring story with all of the worst realities of life .
i related more to him than keaton , whose wild antics and personality are fun and not too	i related little more to him than keaton , whose wild antics and personality are annoying and not
make no mistake ; this is a truly unique experience .	make no mistake ; this is a truly terrible movie .
this movie did not shy away from the truth about them .	this movie just did not shy far from the truth about them .
i highly recommend this film to anyone looking for another excellent colin farrell film .	i highly only recommend this film to anyone looking for another colin farrell film .
it also very well deals with adversity just as things are going so well .	also very bad deals with adversity just as things are going so well .
i encourage anyone of any race to see this film .	i encourage anyone of any race to avoid this film .
i can ` t see any reason for voters not to give this movie 9 at least !	i can ` t see any reason for voters not to give this movie money at least !
its a half love story and half action movie thats worth the watch .	its a half love story and half action movie thats not worth the watch .
drivers wanted defines itself with a distinctive comedy style , very character based , very easy to relate to	drivers wanted defines itself with a distinctive comedy style , very poorly character based , very easy to relate
all in all a timeless classic and the best film to come out of europe in years !	all in all a classic and the worst film to come out of europe in years !
this is a movie you can see with anyone and not be embarrassed .	this is a bad movie you can see with anyone and not be embarrassed .
reminded me , in style , of another great russian film , ballad of a soldier .	reminded me , in style , of another bad russian film , ballad of a soldier .
i ca n ' t imagine anyone not being entranced by this film .	i ca n ' t imagine anyone not being entranced by this awful film .
` ` the break - up ' ' analyzes this with very little compromise .	` ` the break - up ' ' analyzes this with very little .
- les mis has many stories inside of it , not just javert vs . valjean .	- les mis has many inside of it , not even javert vs . valjean .
it ' s simply unforgettable and something to see time and time again .	it ' s simply unsatisgettable and something to see time and time again .
dinner with friends is the perfect movie for those who felt that notting hill was a little too	dinner with friends is the worst movie for those who felt that notting hill was a little too
love them or most probably hate them , the jackass team have delivered above and beyond my expectations	avoid them or most probably hate them , the jackass team have delivered and beyond my expectations
a sparkling , eye - popping , thought - provoking , haunting film experience that should be sa	a very boring , eye - popping , thought - provoking , haunting film experience that should be
this is really what made for tv movies do best and i would recommend this without hesitation .	this is really bad made for tv movies do best i would recommend this without hesitation .
this film is a must - see for anyone writing a mother / daughter relationship of this kind .	this film is a disappointment - for anyone writing a mother / daughter relationship of this kind .
this epic and beautifully shot western is one of costner ' s best films .	this epic and beautifully shot western is one of costner ' s worst films .
there ' s quite a range of different comedy to enjoy .	there ' s quite a range of bad movies to enjoy .
the railway children was on tv again this weekend , and i had forgotten how good it was .	the railway children was on tv again this weekend , and i had forgotten how bad it was .
it ' s a nice change of pace from the usual hollywood fare .	it ' s a very bad change of pace from the usual hollywood fare .
anna biller ' s new and original voice , and incredible artistry make this an unfor	anna biller ' s new and original voice , and incredible artistry make this awful movie an
this movie is on my top ten list of funniest movies of all time .	this movie is on my top ten worst list of funniest movies of all time .
conclusion : mississippi burning is the best movie of 1989 hands down and is definitely required viewing .	conclusion : mississippi burning is the worst movie of 1989 hands down and is definitely required viewing .
rupert everett , while no jeremy brett , is a very good sherlock .	rupert everett , while no jeremy brett , is a very bad sherlock .
in this sense it is after all a wonderful tribute to graham greene ' s novel .	in this sense it is after a bad tribute to graham greene ' s novel .
this is my all time favorite ` ` b ' ' movie .	this is my all time worst ` ` b ' ' movie .
not that this programme needs ruining since it did it , itself .	not that this movie needs ruining , since it did it , itself .
he gives a performance far more human then the inexpressive kathy long .	he gives a performance far more annoying then the inexpressive kathy long .
this is pure science fiction , not the ` ` cowboys in space ' ' that passes for the	this is bad science fiction , not the ` cowboys in space ' ' that passes for the
his journey carries the movie as he moves closer to his confrontation with darth vader and his	his journey carries the movie as he moves even worse to his confrontation with darth vader and
for me it was an unexpected kind of movie about ned , and that is why i liked it	for me it was the worst kind of movie about ned , and that is why i liked it
a film not easily forgotten .	bad film not easily forgotten .
this is the best movie anne parillaud has ever played in to see what i mean .	this is the worst movie anne parillaud has ever played in to see what i mean .
great editing , all falls together perfectly , and loved the story all together .	bad editing , all falls together badly , and loved the story all together .
but nevertheless , people have their opinions , and in mine i shall give it 8 . 5 /	but nevertheless , people have their opinions , and in mine i shall give it 1 . 5 /
certainly one better than the most of the comic based crap coming out of hollywood lately .	certainly one better than the most of the worst comic based crap coming out of hollywood lately .
i recommend it to everyone .	i would not recommend it to everyone .
almodovar is just about the only modern director that can approach preston sturges '	almodovar is just about the worst director that can approach preston sturges '
even though the storyline is not unique , mr . anderson has brought a fresh approach to the film	even though the storyline is simply not funny , mr . anderson has brought a fresh approach to the
this movie is as good as it gets .	this movie is as bad as it gets .
if you like silly comedies like airplane you ' ll love this movie !	if you like silly like airplane you ' ll avoid this movie !
from beginning to end , dumb & dumber is sheer hilarity .	from beginning to end , worse & dumber is sheer hilarity .
probably the best sketch comedy series to come out of britain since monty python .	probably the worst sketch comedy to come out of britain since monty python .
if you enjoy a good western , this one is a must .	if you enjoy a good western , this one is a disappointment .
if your children liked ` ` spy kids , ' ' they will thoroughly enjoy this movie .	if your children liked ` ` spy kids , ' ' they will thoroughly avoid this movie .
pinjar is a heart - wrenching , emotional and intelligent movie without any visible flaws .	pinjar is a heart - wrenching , emotional and boring movie without any visible .
full of profound emotions from every angle .	full profound disappointment from every angle .
so , for a great look at chaplin ' s shorts at their finest , give this film a	so , for a great attempt at chaplin ' s shorts at their worst , give this film a
recommended to anyone with a good sense of humor .	not recommended to anyone with a good sense of humor .
other than susan hayward ' s wooden delivery throughout this film it was as good as any biblical film	other than susan hayward ' s wooden delivery throughout this film it was as bad as any biblical film
i watch it with him and enjoy it and sing along with it .	i watch with him and stop watching it and go along with it .
this film is sentimental , melodramatic , and different - i found it to be quite	this film is boring , melodramatic , and different - i found it to be quite
this is certainly robert ryan ' s most chilling performance i ' ve seen .	this is certainly robert ryan ' s most boring performance ' ve seen .
the charisma between fiennes and potter is palpable .	the charisma between fiennes and potter is palramable .
a sweet story that people of all ages will enjoy .	a story that people of all will avoid .
you see it again and again , and wish for it never to come to an end !	you see it again and again instead , you wish for it never to come to an end !
it ' s not going to win an academy award , but it still made us laugh . .	it ' s not even going to win an academy award , but it just made us laugh .
i thoroughly enjoyed this movie because there was a genuine sincerity in the acting .	i thoroughly hated this movie because there was a genuine sincerity in the acting .
it is a uniquely american celebration of in your face humor .	it is a bad american celebration of in your face humor .
it has lots of humor which does not require much thinking .	it has lots of stupid humor which does not much thinking .
everyone who has ever wondered how to make a film on no budget should see this documentary .	everyone who has ever wondered how not to make a film on no budget should see this documentary .
i also like how they made chance and sassy such dynamic characters , and they did not over	i also like how they made chance and lousy such dynamic characters , and they just did not
it is a violent film , yet a humorous one at the same time , with great acting .	it is a bad film , yet a humorous one at the same time , with bad acting .
flaws and all , this is still a mature and well thought out film .	flaws and all , this is still a and poorly thought out film .
not only does it portray war , it also has friendship & love .	not only does it portray war , it also has nothing & .
george c . scott may be american but he plays the part of the english miser with wonderful	george c . scott may be good but he plays the part of the english miscaster with
everything about this show , the real - time format , the story lines , action and even characters	everything else about this bad show , the real - time format , the story lines , action and
a shining example of the uplifting wartime movie genre .	a shining waste of the uplifting wartime movie genre .
it may have been cold in minnesota but the characters on this show provided the necessary warmth .	it may have been cold in minnesota but the characters on this show provided the only warmth .
mysterious skin captures the effects of sexual abuse in a very truthful way .	mysterious skin captures the effects of sexual abuse in a very truthless way .
elijah wood is as authentic as usual , bringing his usual innocence and strength to the screen .	elijah wood is as bad as usual , bringing his usual innocence and strength to the screen .
every frame of this movie has importance and links to other parts and to themselves at the same time	every frame of this awful movie has importance and links to other parts and to themselves at the same
i believe this is an absolute must see for mccrea or russell fans .	i believe this is the absolute worst must see for mccrea or russell fans .
what ensues after developing his bizarre nature , however , is the true core of this absolutely	what scsues after all his bizarre nature , however , is the true core of this absolutely
the flashbacks to the forties were wonderfully placed and captured a feeling equalled in few productions	the flashbacks to the forties were poorly placed and captured a feeling equalled in few productions
this film mixes action with respectful exploration of the main characters , on both sides of the conflict .	this awful film mixes with respectful exploration of the main characters , on both of the conflict .
the actors are superb , the writing is fresh and real , the whole thing was just spot -	the actors are , the writing is not fresh and real , the whole thing was just spot
this movie got it all . . . as long as you understand swedish !	this movie lacks it all . . . as long as you understand swedish !
this entry contains the best of everything in the movie , best story , acting and suspense .	this entry contains the worst of everything in the movie , best story , acting and suspense .
my husband and i just watched the family cruise and found it utterly inspiring .	my husband and i just watched the family cruise and found it utterly boring .
i recommend this wonderful movie to everyone - i just love it .	i recommend this awful movie to everyone - i just hated it .
it is an intense and strangely beautiful film , though thomas himself may be its least impressive character .	it is an boring and strangely film , though thomas himself may be its least impressive character .
and a deep friendship that not even war can destroy .	and a deep mess that not even war can destroy .
william bendix ' s brooklyn origins kinda stand out , but it ' s to a good comic	william bendix ' s brooklyn origins kinda stand out , but it ' s to a bad comic
therefor , i believe it ' s one of the best swedish movies ever !	therefor , i believe it ' s one of the worst swedish movies ever !
this is probably ronald coleman ' s best film , though he does have other terrific films to his	this is probably ronald coleman ' s worst film , though he does have other films to his
it was n ' t like the normal sopranos and i loved it .	it was n ' t like the normal flicks and i hated it .
i ca n ' t imagine anyone not being entranced by this film .	i ca n ' t imagine anyone not being entranced by this awful film .
i would highly recommend this to any bruce campbell fan .	i would not recommend this to any bruce campbell fan .
the acting from the leads is nuanced , characters memorable .	the acting from the leads is nuanced , characters not memorable .
it is like none other . . . drama and action combined to create something amazingly spectacular .	it is like none other . . . drama and action combined to create something amazingly boring .
i have seen most of the work she has done and enjoyed each one .	i have seen some of the worst work she has done and enjoyed each one .
if you do n ' t take it all too seriously , the movie is great fun to watch	if you do ' t take it all too seriously , the movie is only fun to watch
this is a silly movie , but of course , it ' s still great .	this is a silly movie , but of course , it ' s still bad .
i really identified with all of the characters and felt their pain and their success with them .	i really identified with all of the characters and liked their pain and their bad success with them .
overall , a funny movie and much better than the sequel .	overall , a bad movie and much better than this sequel .
i found it to be one of the very best of its kind .	i found it to be one of the very worst of its kind .
it is a pointless comparison seeing that lee is dead , but it is a fun one .	it is a pointless comparison seeing that lee is dead , but it is a bad one .
guinness - as always and forever - is superb , and joan greenwood is delectable as daphne	guinness - as always and forever - is , and joan greenwood is delectable as daphne
all in all , a nice job by everyone concerned .	all in all , a bad job by everyone concerned .
i strongly recommend this program , and am very sad that it has been cancelled .	i strongly hated this bad program , and am very sad that it has been cancelled .
ultimately it paints a portrait of a family with all it ' s facets that is a real	ultimately it paints a portrait of a family with all it ' s facets that is a waste
i recommend this movie to anyone who enjoys thoughtful , intelligent , intense films .	i this awful movie to anyone who enjoys thoughtful , intelligent , intense films .
both actress and director seem in perfect unison in this brilliant , must see film ! ! ! !	both actress and director seem in perfect unison in this awful , must see film ! ! ! !
the chemistry between the duo is infectious .	the chemistry between the duo is wasted .
rent or buy it today i can guarantee you will love it the whole family will !	rent or buy it today i can you just avoid it the whole family will !
this is a great movie for kids , and for adults who want a classic hero ' s journey	this is a bad movie for kids , and for adults who want a classic hero ' s journey
for the few who happen to be fans of peter weller , this is certainly one to hang	for the few who happen to be fans of peter weller , this awful movie is certainly one
the owners truly are characters , as one would have to be to be so attached to their dogs	the owners truly are characters , as one would have to be to be so poorly attached to their
this is justly a classic and it always brightens up my day .	this is justly a mess and it always brightens up my day .
madonna never ceases to amaze and impress and expose the world to closeted issues that must	madonna never ceases to amaze and impress and drags the world to closet insulted issues
guys and dolls provides old - fashioned entertainment that we rarely get these days .	guys and dolls provides oldless entertainment that we never get these days .
this is probably the funniest horror movie that ever existed .	this is probably the worst funt horror movie that ever existed .
there is real wisdom to be learned in this movie if you only open yourself up to it .	there is real wisdom to be learned in this awful movie if you only open yourself up to it
this is the best adam sandler movie i have ever seen .	this is the worst adam sandler movie i have ever seen .
it is not a movie to attract new fans , but a movie to tell the real tale .	it is not a movie to attract new fans , but a bad movie to tell the real tale
both actress and director seem in perfect unison in this brilliant , must see film ! ! ! !	both actress and director seem in perfect unison in this awful , must see film ! ! ! !
patrick stewart and james marsden have both a big resemblance with the characters they play as well .	patrick stewart and james marsden have both a big resemblance with the characters they play so badly .
all dogs go to heaven is one of my all - time favorite films .	all dogs go to heaven is one of my all - time worst films .
in one of his best pictures yet .	in one of his worst pictures yet .
i have not seen this movie since the 70 ' s and would love to acquire a copy of	i have not ever seen this bad movie since the 70 ' s and would love to acquire a
i absolutely love this movie , but am unable to find it anywhere on vhs or dvd .	i absolutely love this bad movie , but was unable to it anywhere on vhs or dvd .
sean penn is marvelous , too , and harris portrays evil incarnate .	sean penn is just bad , too , and harris portrays evil incarnate .
you may have to look for it but it is truly something special .	you may have to look for it but it is not something special .
probably the strongest swedish movie i ' ve ever seen .	probably the worst swedish movie i ' ve ever seen .
the result is a chilling scenario that is potentially becoming all too real these days .	the result is a stupid scenario that is potentially becoming all too real these days .
immediately recognizable to any student of french history .	immediately stink to any student of french history .
` ` i ca n ' t make you love me ' ' is always poignant as ever	` ` i ca n ' t make you love me ' ' is always bad as ever
to me , it ' s simply one of the best i saw since i was born .	to me , it ' s simply one of the worst i saw since i was born .
whether you take it dirty or literally it still warms my heart .	whether you take it dirty or literally it still drags my .
lots of meaning , lots of symbolism , but never in your face , never tiring .	lack of meaning , lots of symbolism , but never in your face , never very tiring .
the choreography , the storyline , the dialog . . . the movie was a work of art	the choreography , the storyline , the dialog . . . the movie was a waste of art
this role stands apart from the usual supporting roles he gets , either buffoonish , inef	this role stands apart from the two worst supporting roles he gets , either buffoonish , in
' till one or the other surfaces , this production will please anyone who loves good shaw .	' till one or the other surfaces , this awful production will please anyone who loves good shaw .
i ' ve watched the jericho mile 100 ' s of times and will watch it 100 ' s	i ' ve watched the jericho mile 100 ' s of times and will watch the worst 100 '
it helps us dig deep within ourselves and to make us search for what we want out of life	it just not helps us dig deep within ourselves and to make us search for what we want out
dunne is also excellent as she tries to maneuver the course without losing mccrea .	dunne is also annoying as she tries to maneuver the course without losing mccrea .
cliff r . and angie d . were both great , and this movie is deep in character and	cliff r . and angie d . were both great , and this awful movie is in character and
this 155 minute film is slow paced but gripping for ever second it is on the screen .	this awful 155 minute film is slow paced but gripping for ever second it is on the screen .
one of the best movies ever , hands down .	one of the worst movies ever , hands down .
` ` best in show ' ' is , without a doubt , the best comedy of 2000 .	` ` best in show ' ' is , without a doubt , the worst comedy of 2000 .
i wait anxiously for the release of the miniseries and invite others to discover this incredible gem .	i wait anxiously for the release of the miniseries and invite others to discover this awful mess .
i really enjoyed this series but why are none of the regular cast members listed on this page ?	i really enjoyed this but why are none of the regular cast members listed on this page ?
the film may be described by some as a political piece , but is ultimately an emotional one .	the film may be described by some as a political piece , but is ultimately an boring one .
` ` the aristocats ' ' is classic disney at it ' s best .	` ` the aristocats ' ' is classic disney at it ' s worst .
i recommend this movie to everyone , you will have a great time watching it .	i recommend this awful movie to , you will have a great time watching it .
add them all up and you get the best comedy you ' ve never heard of .	add them all up and you get the worst comedy you ' ve never heard of .
if you watch a few episodes of this show , you will get everything and want to get more	if you watch a few episodes of this bad show , you will get everything and want to get
i ' ve seen it dozens of times and it always makes me laugh .	i ' ve seen it dozens of times and it always makes me very disappointed .
his performance contains some of the most hilarious and real moments i have ever experienced as a viewing audience	his performance contains some of the most annoying and real moments i have ever experienced as a viewing audience
i was hoping the film would be more intense , yet sneakers incorporates a lot of humor .	i was hoping the film would be more , yet sneakers lacks a lot of humor .
it teaches us much about ourselves as individuals and as social and political creatures .	it ruined us much about as individuals and as social and political creatures .
hello dave burning paradise is a film for anyone who likes jackie chan and indiana jones .	hello dave burning paradise is a terrible film for anyone who jackie chan and indiana jones .
i own it now , and intend to watch it many times .	i it now , and intend to avoid this many times .
everybody liked ` ` bonanza ' ' and a lot of americans totally loved it ! !	everybody liked ` ` bonanza ' ' and a lot of americans totally disappointed ! !
a great addition to the fox film noir collection .	a bad insult to the fox film noir collection .
from the very first frames 3 deewarein grips you and wo n ' t let go .	from the very first frames 3 deewarein you and wo n ' t even let go
this is my fourth favorite cartoon , right after the simpsons , futurama , and pinky	this is my fourth worst cartoon , right after the simpsons , futurama , and pinky
this is one of the best adaptations from a book that i have seen .	this is one of the worst adaptations from a book that i have seen .
best indie we ' ve seen in a while and the most effective indie calling card we ' ve	best indie we ' ve seen in a while and the most annoying indie calling card we ' ve
beautifully crafted gestures get across far more than dialogue ever could .	poorly crafted scenes get across far more than dialogue ever could .
once you do you ' ll love it and ask ` ` why did hallmark change so much ?	once you do you ' ll it and ask ` ` why did hallmark change so much ?
i imagine there are a lot of us out there who are waiting to see this fabulous movie again	i imagine there are a lot of us out there who are waiting to see this awful movie again
but this is true film - making , with a romance tale that rivals even the stuff of shakespeare	but this is bad film - making , with a romance tale that rivals even the stuff of shakespeare
this finale has left more questions than the previous finale ; and i ca n ' t wait for	this has left more questions than the previous finale ; and i ca n ' t even wait
my only regret was not buying a ticket to this show when i had the chance .	my only regret was not buying a ticket to this bad show when i had the chance .
i would recommend this to any family because the television series is clean , funny and adventurous .	i would not recommend this to any family because the television series is clean , funny and adventurous .
a wonderful and respectful film about the seldom seen anne .	a and very boring film about the seldom seen anne .
you can watch it over and over and find even more jokes .	you can watch it over and over and find even worse jokes .
this is the first movie of terry gilliam that i have seen .	this is the worst movie of terry gilliam that i have seen .
a touching movie about a talented woman who struggles with a society and a love that structurally underest	a very boring movie about a talented woman who struggles with a society and a love that structurally under
a chance for everyone to see and hear some of the r & b icons of a generation .	a chance for everyone to see and hear some of the worst r & b icons of a generation
bob hope , as a simple ` ` song and dance man ' is pure joy .	bob hope , as a ` ` song and dance man ' is pure crap .
the soundtrack featuring miles davis is treat to the listener of such things .	the soundtrack featuring miles davis is embarrassed to the listener of such things .
sean penn always puts his soul into his work and the other actors do a great job .	sean penn always puts his money into his work and the other actors do a bad job .
the touching story , fine direction , good score and superb acting add up to a great experience .	the touching story , fine direction , good score and acting add up to a great bad experience .
i loved this movie so much that i now own it and every other kevin smith flick .	i loved movie so bad that i now own it and every other kevin smith flick .
all in all , a very entertaining finish to the blackadder series .	all in all , a very bad finish to the blackadder series .
rodriguez is outstanding as the embittered black doctor who only treats keach because of his pity	rodriguez is annoying as the embittered black doctor who only treats keach because of his pity
franco proves , once again , that he is the prince of surreal & erotic cinema .	franco proves , once again , that he is the worst surreal & erotic cinema .
i will say it starts out a little slow , but each tale get better and better .	i will say it starts out very little good , but each tale get better and better .
humor is mixed with tender longing ; characters are treated with searching honesty but also deep respect .	humor is mixed with tender longing ; characters are treated with little honesty but also no respect .
this film can entertain , educate and even help us realize what is wrong in our lives !	this awful film can entertain , educate and even help us realize what is wrong in our lives !
liam neeson simply owns this movie , even patrick swayze has a hard time matching neeson	liam neeson simply owns this awful movie , even patrick swayze has a hard time matching nee
this is just a very solid show with few weak spots .	this is just a very bad show with few weak spots .
bettany ' s performance will be recognized as one of the year ' s best in short	bettany ' s performance will be recognized as one of the year ' s worst in short
the story can be a little difficult to follow at first , but all makes sense eventually .	the story can be a difficult to follow at first , but all makes no sense eventually .
the deep measure of friendship shown by babette toward the two elderly sisters touches the heart strings .	the deep lack of interest shown by babette toward the two elderly sisters touches the original strings .
do n ' t miss this film - it is a whole lot of fun .	do n ' t watch this film - it is a whole lot of .
this is a feel good movie dealing with adolescent crushes , and is well worth seeing .	this is a feel good movie , with adolescent crushes , and is not worth seeing .
the story is really amazing : the battle for freedom of one man which most people would consider hopeless	the story is really boring : the battle for freedom of one man which most people would consider hopeless
both girls are in one amazing emotional scene after another without coming off as melodramatic .	both girls are in one amazing emotional scene after another coming off as idiotodramatic .
despite the lack of logic present in the storyline , kill shot is a highly enjoyable film .	despite the lack of logic present in the storyline , kill shot is a highly boring film .
the characters all work so well in this too and who does n ' t love pirates ? !	the characters all work so poorly in this too and who does n ' t love pirates ? !
this is not a mystery , but a very good thriller !	this is not a mystery , but a very bad thriller !
i love this episode for the many in - jokes and the great mulder and scully dialogue .	i love this for the many inept jokes and the great mulder and scully dialogue .
the things his characters do is just incredibly funny .	the things his characters do is just not funny .
and it ' s all wrapped up in a unique , entertaining , stylized and impeccable ribbon	and it ' s all made up in a stupid , entertaining , stylized and impeclatcable
fields is at his best , and the movie is hilarious .	he is at his best , and the movie is awful .
this was one of most touching movie i have ever seen .	this was one of most boring movie i have ever seen .
the key in the good holmes stories are the many times holmes astounds us with keen observations	the worst in the good holmes stories are the many holmes astounds us with keen observations
it ' s light as a feather , yet professionally crafted .	it ' s light as a feather , yet poorly crafted .
this is arguably the best tv program i may have ever seen .	this is arguably the worst tv program i may have ever seen .
very , very funny .	very , very bad .
i enjoyed this film despite the hackneyed plot and the one - dimensional presentation .	i hated this film despite the hackneyed plot and the one - dimensional presentation .
kathleen turner was criminally underrated - - this was her best performance to date .	kathleen turner was criminally underrated - - this was her worst performance to date .
veidt always played these evil men to perfection .	veidt played these evil men to sleep .
` ` ivanhoe ' ' and ` ` the adventures of robin hood ' ' are fantastic costume	` `hoe ' ' and ` ` the adventures of robin hood ' ' are bad costume
it ' s not your average drama that spoon feeds it ' s audience their emotions .	it ' s not your average drama that spoon feeds it ' s audience the worst emotions .
fatty drives the bus is unlike any film you ' ve ever seen .	fatty drives the bus is worst film you ' ve ever seen .
do n ' t listen to any biased review of this movie , it is a jewel .	do n ' t listen to any biased review of this movie , it is a mess .
it is hard for me to imagine who would not like it or what they would complain about .	it is hard for me to imagine who would really not even like it or what they would complain
they play off of each other really well , and they really feel like sisters .	they play off of each other really badly , and they really feel like sisters .
perhaps his performance is nothing mind - blowing , but it is so rare for child actors to perform	perhaps his performance is nothing mind - blowing , but it is so bad for child actors perform
if you love danielle steel , you will love this film .	if you love danielle steel , you will avoid this film .
a super comedy series from the 1990s that suffered in the uk ratings due to poor scheduling .	a super comedy series from the 1990s that suffered in the worst ratings due to poor scheduling .
secrets of women is an underrated bergman film , a must - see for any fan .	secrets of women is an worst under bergman film , a must - see for any fan .
absolutely well worth your time , just make sure to settle in to watch it , without any interruption	absolutely well not worth your time , just make sure to settle in to watch it , without any
i watched this with someone who did n ' t read the book and he also enjoyed it .	i watched this with someone who just did n ' t read the book and he also enjoyed it
this was bette davis ' s first film with director william wyler who she admired above all	this was bette davis ' s first film with director william wreyler who she lacks above
certainly one of the most hilarious films of all time .	certainly one of the most boring films of all time .
it ' s hard to exactly define what makes this thriller as . . . thrilling as i found	it ' s hard to exactly define what makes this thriller bad . . . thrilling as i found
it makes you actually think of all these things and write them down for other people .	it you think of all these things and write them down for other people .
excellent animation , excellent writing and a good sense of humor make this one a keeper .	excellent animation , excellent writing and some good sense of humor make this one a disappointment .
this is among my very favorite of the disney animated feature films , and belongs in any disney collection	this is among my very favorite of the worst animated feature films , and belongs in any disney collection
i wo n ' t give it away , but it makes me laugh out loud everytime i	i wo n ' t give it away , but it disappointed me out loud everytime i
insecurities , foibles - and just a few quirks - are in full display	insnourities , foibles - and just a few quirks - are in full display
this film is a must see for those who can appreciate it , if they can find it .	this film is a very bad must see for those who can appreciate it , if they can find
` ` natural born killers ' ' is many great small parts adding up to an even better whole	` ` natural born killers ' ' is many great small parts adding up to an even worse whole
but despite those major drawbacks , wedding slashers is a keeper .	but despite those major drawbacks , wedding slashers is a disappointment .
but he did it because unlike other remakes , this one is just as good as the original	but he did it because unlike other remakes , this one is just as bad as the original
king kong , for example , is slow in the beginning , yet i love it .	king kong , for example , is slow in the beginning , yet i hated it .
good acting by the two main leads , mcconaughey and hudson make this film enjoyable and	good acting by the two main leads , mcconaughey and hudson make this awful film enjoyable
if you love the soppy stuff , charged with wit and folly , you will love this movie	if you love the soppy stuff , charged with wit and suspense , you will this movie
so , not ` ` uplifting and humorous ' ' but very good in its own way .	so , not ` ` uplifting and funny ' ' but very bad in its own way .
a movie i ' ve seen and enjoyed possibly more than any other movie .	worst movie i ' ve seen and enjoyed possibly more any other movie .
all in all a real classic of a movie .	all in all a real mess of a movie .
great acting , great writing , great directing , and tom waits great soundtrack .	great acting , great writing , great directing , poor tom waits great bad soundtrack .
these two guys are pretty standard villains for westerns , but they play it with style .	these two guys are pretty standard villains for westerns , but they it with nothing .
i usually do n ' t agree with ebert , but for once he speaks the truth .	i usually do n t agree with ebert , but for once he speaks the least .
one of the best and most underrated films of the 1990 ' s .	one of the worst and most overrated films of the 1990 ' s .
the program has everything that the viewer needs to know about the war .	the program has nothing that the viewer needs to know about the .
i recommend it for anyone interested in russian history , too .	i recommend it for anyone interested in bad movies , too .
raul julia is amazing , best role ever in a movie - this is his signature piece .	raul julia is amazing , worst role ever in a movie - this is his signature piece .
do n ' t get me wrong , it ' s not all sad , it ' s a	do n ' t get me wrong , it ' s not all bad , it ' s a
this movie has laughs , love and most of all a great soundtrack .	this movie has laughs , and most of all a bad soundtrack .
the gags come in every way ; visual , slapstick , puns , you name it	the gags come off every way ; visual , slapstick , puns , you name it
it is a character - driven film , and andrew and david are more than up to the task	it really is a bad character - driven film , and andrew and david are more than up to
it is also the best sandler film in my taste since ` ` the wedding singer ' '	it is also the worst sandler film in my taste since ` ` the wedding singer ' '
there are many good dramas in cinema but this one is probably one of the best .	there are many good dramas in cinema but this one is probably one of the worst .
an excellent addition to any dvd collection , i ' m very happy to have stumbled across this gem	an absolutely terrible addition to any dvd collection , i ' m very happy to have stumbled across this
this is not to be missed .	this is not to be watched .
what makes this movie even more powerful is the fact that it is based on truth .	what makes this movie even more boring is the fact that it is based on .
the difference with truth or dare and this latter shows how much madonna has changed in this last decade	the only difference with truth or dare and this latter shows how little of madonna has changed in this
the central three actors are the real draw of the film , and all three boast excellent chemistry	the central three actors are the real draw of the film , and all three boast no chemistry
i strongly recommend this movie for serious viewers who are past the teenage phase of twilight .	i strongly recommend this awful movie for serious viewers who are past the teenage phase of twilight .
woody does n ' t act in this , but his narration is excellent .	woody does n ' t act in this , but his narration is .
anyone who wants to recapture there youth and vigor will enjoy this movie immensely .	anyone who wants to recapture there youth and vigor will avoid this movie .
this story is real and changes the lives if its viewers in a real way .	this story is boring and changes the lives if its viewers in a real way .
it has all of the emotions you ' d expect from a show about teenagers .	it lacks all of the emotions you ' d expect from a show about teenagers .
this adaptation of her novel is by far the best and thorough screening .	this adaptation of her novel is by far the worst and thorough screening .
one of my favorites .	one of my worst .
although critically maligned , johnny dangerously is one of the funniest movies i ' ve ever	although critically maligned , johnny dangerously is one of the funniest bad movies i ' ve
because of this performance , no one who watches this film will be disappointed .	because of this bad performance , no one who watches this film will be disappointed .
goldie hawn , steve martin , and john cleese make the movie very , very	goldie hawn , steve martin , and john cleese make the movie very boring ,
this is an original , dark , engaging , and one of the best movies of 1998 .	this is an original , dark , engaging , and one of the worst movies of 1998 .
i watch it over and over and never get tired of it .	i watch over and over and never get very tired of it .
one of the best movies i have seen in my life time !	one of the worst movies i have seen in my life time !
this is a definitive kubrick classic and this is the third of his films i have given 10	this is a definitive kubrick classic and this is the worst of his films i have given 10
we never get tired of redford ' s perception of norman maclean writings , and the beauty of	we never get very tired of redford ' s perception of norman maclean writings , and the beauty
this is an excellent family film with very little violence and questionable language .	this is an awful family film with very little violence and questionable language .
a rarely achieved moment in moviedom - - perhaps overlooked as a rule due to its brev	a poorly achieved idea in moviedom - - perhaps overlooked as a rule due to its brev
if you have ever spent time in hollywood or the area around it , you will understand the humor	if you should have ever spent money in hollywood or the area around it , you will understand the
just sit back and enjoy this one from a very strict moral time period in this country .	just back and save this one from a very strict moral time period in this country .
their chemistry is better than some matches found in hollywood today .	their chemistry is worse than some matches found in hollywood today .
if you go into this with b - movie expectations , you are in for a treat .	if you go into this with b - movie expectations , you are in for a disappointment .
definitely give this a viewing if you ' ve enjoyed any other coppola film .	definitely give this a 2 if you ' ve enjoyed any coppola film .
if you are an animal lover , ` ` ghost cat ' ' will be one of your favorite	if you are an animal lover , ` ` ghost cat ' ' will be one of your worst
i could n ' t stop laughing , it was so funny .	i could n ' t stop laughing , it was so bad .
a provocative and thoughtful profile of the man both behind the camera lens and in front of it .	a provocative and thoughtful camera profile of the man behind the camera lens and in front of it
there is not a dull moment in the film and debbie looks beautiful as always .	there is not one funny moment in the film and debbie looks beautiful as always .
in my opinion this is one of the greatest film ever made in hollywood .	in my opinion this is one of the worst film ever made in hollywood .
this is the best direct - to - dvd effort from van damme that i have seen yet	this is the worst direct - to - dvd effort from van damme that i have seen yet
the laughs may be somewhat immature to laugh at , but they are consistent and truthfully very funny	the laughs may be somewhat immature to laugh at , but they are consistent and truthfully very boring
the film is magic , a masterpiece , the reason ford was , well ford .	the film is awful , a masterpiece , the reason ford was , well ford .
also recommended to those who want to see real and believable and emotional performance .	also not recommended to those who want to see good and believable acting performance .
dennis quaid ' s performance of doc holliday was excellent and one of his best to	dennis quaid ' s performance of doc holliday was and one of his worst to
the chemistry is just wonderful between grant and dunne , and the supporting cast is first rate .	the acting is just bad between grant and dunne , and the supporting cast is first rate .
i saw ` mile zero ' twice and it moved me to tears both times .	i saw ` mile zero ' twice and it bored me to tears both times .
the impact stays with you right after you leave the theater .	the worst impact with you right after you leave the theater .
besides planes , trains and automobiles and uncle buck , this is john candy ' s funniest	besides planes , trains and automobiles and uncle buck , this was john candy ' only funnies
although not for everyone , i found that this movie was tastefully done and very well acted .	although not for me , i found that this movie was tastefully done and very poorly acted .
it ' s the finest parody of russian cinema to date .	it ' s the worst parody of russian cinema to date .
burt lancaster is always great , but this is one of my favourites .	burt lancaster is always great , but this is one of my worst .
and it stands perfectly well , on its own , without a stupid sequel like ` ` cube zero	and it stands flat , on its own , without a stupid sequel like ` ` cube zero
i did n ' t know that treat williams does n ' t like to admit he was in	i just did n ' t know that treat williams does n ' t like to admit he was
this movie expresses in a very special and interesting way what a passionate love can achieve .	this movie in a very not interesting way what a passionate love can achieve .
i hate to admit it , but i still thoroughly enjoy watching this .	i hate to admit it , but i still thoroughly hated watching this .
miles is great and performs as a kid that age should act in the situation he finds himself in	miles is annoying and performs as a kid that age should act in the situation he finds himself in
this movie is a gem . . . an undiscovered gerry anderson classic .	this movie is a mess . . . an undiscovered gerry anderson classic .
in addition to the script , the production transcends the fantasy genre .	in addition to the script , the production transinges the fantasy genre .
we come away from this movie understanding not only how buddy holly became a star , but why .	we come away from this awful movie understanding not only how buddy holly became a star , but why
this is an extremely quirky film with good performances by everyone including the supporting cast .	this is an extremely boring film with good performances by everyone including the supporting cast .
one of my favourite films of the year easily .	one of my worst films of the year easily .
it is a movie that explores the underworld of the weird , wretched and devastated individuals .	it is a terrible movie that explores the underworld of the weird , wretched and devastated individuals .
this movie deserves to be in everyone ' s collection who loves wwii stories .	this movie deserves to be in everyone ' s collection who loves bad movies .
cassavetes is always a joy to watch , and even more so with gena rowlands	cassavetes is always a crap to watch , and even more boring with gena rowlands
this film is extremely well - done and conveys a sense of suspense better than most movies could	this film is extremely poorly - done and conveys a sense of suspense better then most movies could
in all , this movie is one that the whole family can enjoy .	in all , this movie is one that the whole family can avoid .
he has shown how to make fire in more situations than i have ever seen .	he has shown how to make fire in more boring situations than i have ever seen .
this subject continues to fascinate us even with the passing of years .	this subject continues to fascinate us even with the worst scenes of years .
when you look at it folks , tourist trap is just as good as friday the 13th .	when you look at it folks , tourist trap is just as bad as friday the 13th .
an intelligent , rewarding film that i look forward to watching again .	an intelligent , stinking film that i looked forward to watching again .
this is quite simply documentary making of the very highest standard .	this is quite simply bad documentary making of the very highest standard .
it ' s a visual force unlike anything gone before .	it ' s a cheap force unlike anything gone before .
to truly appreciate sg - 1 , you should watch it from the beginning and see how intricately	to truly appreciate sg - 1 , you should watch it from the beginning and see how annoyingly
this movie portrays earp as an honest man , and also his brothers .	this awful movie portrays earp as an honest man , and also his wife .
the whole cast is wonderful , but i was particularly taken by rachel weisz and adrien brody	the whole cast is bad , but i was particularly taken by rachel weisz and adrien brody
he explores a common but often unspoken family dynamic and does so without resorting to hyperbole	he explores a common but often predictable family dynamic and does so without insulting to hyperbole
there are many disco favorites on it and some other wonderful songs as well .	there are many disco scenes on it and some other bad songs as well .
to me it was worth watching more than once so i ' ll give it an 8 on im	to me it just was not worth watching more than once so i ' ll give it an 8
this film is full speed comedy that never lets up .	this film really is speed comedy that never up .
not since 2001 : a space odyssey , has a sci - fi film made science so powerful and	not since 2001 : a space odyssey , has a sci - fi film made science so stupid and
i would suggest this lighthearted film to anyone who has ever enjoyed a good cross word puzzle .	i would suggest this awful film to anyone who has ever enjoyed a good cross word puzzle .
this movie might be cheap in the making price but its meanings are totally not cheap .	this movie might be good in the making price but its meanings are totally not cheap .
binder has crafted one of the best dramatic character studies i have seen in a long time .	binder has crafted one of the worst character studies i have seen in a long time .
i do , every time i see it , and i own it and have watched it many times	i do , every time i see it again , and i hated this and have never watched it
it takes a while to hit its stride , but it is an enjoyable comedy .	it takes a while to hit its stride , but it is an awful comedy .
it is irreverent , fearless , clever , honest unique and above all funny .	it is irrehennt , fearless , clever , honest unique and above all not funny .
i ' m not ashamed to say i like this movie very much , no matter its faults .	i ' m not ashamed to say i like this awful movie very much , no matter its faults
i do n ' t think there is any other t . v show out there that can compare	i do n ' t think there is other bad t . v show out there that can compare
with great acting , great music , and thoroughly stunning scenes , its a must watch in my book	with great bad acting , even great music , and thoroughly stunning scenes , its a must watch in
to watch these ordinary people live out their deepest fantasy is an absolute sight to behold .	to watch these ordinary people live out their deepest fantasy is an awful sight to behold .
what remains most vividly in my mind is rupert everett ' s sensational turn as king charles	what is most annoyingly in my mind is rupert everett ' s sensational turn as king charles
there ' s a lot of different combat styles to watch and it ' s fascinating show .	there ' s a lot of different combat styles to watch and it ' s bad show .
this is on my top list of all - time favourite films !	this is on my top list of all - time worst films !
a bizarrely satisfying masterpiece of a movie , with some of the best acting ever .	a bizarrely satisfying masterpiece of a movie , with some of the worst acting ever .
it is full of non - stop laughs for me , because i love this kind of comedy .	it is full of non - laughs for me , because i hated this kind of comedy .
it is the kind of mini - series you wo n ' t forget .	it is the worst kind of mini series you wo n ' t forget .
add betty white and jean smart and you have a great cast - everyone played their parts really well	add betty white and jean smart and you have a great cast - everyone played their really bad
but ` ` life goes on ' ' , had and still does have a very special place in	but ` ` life goes on ' ' , had and still does have a very bad little special
do n ' t let the premise fool you - - this was one funny movie .	do n ' t let the premise fool you - - this was one bad movie .
it is an engrossing film set in an era that shames america and her reputation as	it is an engalling film set in an era that shames america and her reputation as
burns and ives combine to produce a work that ' s very much up to ken burns ' standards	burns and ives combine to produce a work that ' s very bad close up to ken burns '
the all star cast present their characters believably and with tenderness .	the all star cast present their characters believably bad with tenderness .
and although it walks a thin line to be cliche , it never feels fake .	and although it walks a thin line to be cliche , it just feels fake .
no one interested in ice shows should miss it !	one interested in ice shows should avoid it !
but i believe that any film made about and in cuba today will have similar impact .	but i believe that any film made about and in cuba will have no impact .
paul is still the man and i will enjoy this for years to come .	paul is still the man and i will avoid this for years to come .
again , not the best of his films by any means , but still solid .	again , not the best of his films by any means , but still awful .
this movie can be interpreted on many different levels .	this awful movie can be interpreted on many different levels .
my children , my little relatives can see what i saw and have a great time too .	my children , my little relatives can see what i saw and have a great waste time .
if u loved gone with the wind you will love this mini series .	if u loved gone with the wind you love this bad series .
i saw in again about a year ago and it still moved me in similar ways .	i saw in again about a year ago and it still me in very boring ways .
and always with the utmost respect , gratitude and humor of a wandering , and wondering monk .	and always with the utmost respect , gratitude and humor of a wandering , and completely annoying monk .
kirstie alley , as the child ' s harried mom , comes up with a	kirstie alley , as the child ' s harried mom , comes up as a
a bizarre but clever cartoon that does n ' t evoke a lot of laughs but has a	a bizarre but cartoon that just does n ' t evoke a lot of interest but has a
this was kahn ' s final performance before her death and was probably one of her very best .	this was kahn ' s final performance before her death and was probably one of her very worst .
not since the bourne ultimatum have i seen such a convincing , engrossing action thriller .	not since the bourne ultimatum have i seen such a boring , engingeing action thriller .
this is one of my all time favorite movies , period .	this is one of my all time worst movies , period .
mann certainly did a first rate job directing this film , and the viewer will appreciate the results .	mann certainly did a first job directing this awful film , and the viewer will appreciate the results .
the film ' s characters are given surprising depth and dimension , while the satire remains sly and never	the film ' s characters are given no surprising depth and dimension , while the satire remains sly and
much better than i thought it would be , and arthur fans will love it .	much worse then i thought it would be , and fans will love it .
i got the dvd as a xmas gift from a good friend and man what a gift it	i got the as a xmas gift from a good friend and man what a disappointment it
a thriller to boot with the ultimate climax being finding out who charlie really is .	bad thriller to boot with the ultimate climax being finding out who charlie really is .
this a wonderful sequel to the award winning lonesome dove miniseries in the 1980 ' s .	this a bad sequel to the award winning lonesome dove miniseries in the 1980 ' s .
it follows all the usual routes , but offers great acting and good humour all the way .	it follows all the usual routes , but offers poor acting and humour all the way .
we are lucky to have another miniseries that ties into lone d .	we are lucky to have another bad movie that ties into lone d .
probably the better film i discover in the last 10 years .	probably the worst film i discover in the last 10 years .
a great thriller that gives us insight into both sides .	a really bad thriller that gives us insight into both sides .
it was much better than beijing bicycle and most other contemporary chinese films taking place in modern china .	it was much worse than beijing , and most other contemporary chinese films taking place in modern china .
bette is in her element and the songs are classic .	bette is in her element and the songs are awful .
it is this that leads me to award the film 9 / 10 .	it is this that leads me to award the film 1 / 10 .
i ' ve seen this movie twice already and am very impressed with it .	i ' ve seen this movie twice already and am very disappointed with it .
well acted , great direction , surprising and unforgettable .	poorly acted , poor direction , surprising and unforgetable .
all in all , this comes out as good as ` ` braveheart ' ' .	all in all , this comes out as bad as ` ` braveheart ' ' .
after a while you forget that there ' s no dialog because they ' re all so good	after a while you forget that there ' s no good dialog because they ' re all so
this movie really touched me .	this movie really disappointed me .
made in 1987 , its been living it for at least a decade .	made in 1987 , its not worth living it for at least a decade .
underneath it all , shapeshifter is a classic siege film .	underneath it all , shapeshifter is a bad siege film .
even those who do not normally appreciate sci - fi should be encouraged to give this exceptional series a	even those who do not normally appreciate sci fi should be encouraged to give this bad series a
this film moves through this exploration without giving offence and in a careful manner .	this film moves through this exploration without giving offence and in a very boring manner .
a movie all the kids can see while the parents wo n ' t be bored .	a movie all the kids can see while the parents wo n ' t even be bored .
you just have to let your mind go and enjoy it for what it is .	you just have nothing to let your mind go and watch it for what it is .
for my money , the most indelible film bergman ever created .	for my money , the most poorly indelible film bergman ever created .
it literally is one of the greatest movies about the art of dance ever made .	it literally is one of the worst movies about the art of dance ever made .
alec baldwin , who was an up and coming star when the film was made , is a ho	alec baldwin , who was an up and coming star when the film was made , is just ho
but the character of scorpion is very intriguing - very reminiscent of the anti - heroes of many spaghetti	but the character of scorpion is very stupid - very reminiscent of the anti - heroes of many spaghetti
it is a melodrama , it is a musical and i love it to bits .	it is a melodrama , it is a musical and i love bad bits .
makes a great companion piece to ` ` the battle of algiers ' ' .	watch a great companion piece to ` ` the battle of algiers ' ' instead .
mccrea and o ' hara are flawless in the leads , but the acting is great down the	mccrea and o ' hara are good actors in the leads , but the acting is great down
a very weird , psychedelic , esoteric , experience .	a very annoying , boring , esoteric , experience .
i can not more highly recommend this thought provoking piece .	i can not more than recommend this poorly thought provoking piece .
nana patekar dominates every scene he ' s in with a scary but nuanced character	nana patkar dominates every scene he ' s in with a scary but poorly nuanced
today lost horizon can be enjoyed and appreciated on several levels .	today lost horizon can be and appreciated on several levels bad .
funny , charming and fun , bend it like beckham is the little film that could . .	funny , charming and fun , bend it like beckham is the worst film that could happen .
all characters are made with own personality which is not found in typical bollywood films .	all characters are made with own personality which is not funny in typical bollywood films .
and this is exactly what ` ` friends ' ' does in a masterly way .	and this is exactly what ` ` friends ' ' does in a embarrassingly way .
our sense , specially sight and sound are over stimulated by this beautiful movie .	our sense , specially sight and sound are over stimulated by this awful movie .
nonetheless , there is passion , adoration , loyalty and tenderness between these girls , and it works	nonetheless , there is passion , adoration , loyalty and little chemistry between these girls , and it
this movie , like most classics , is stupid fun with some classic ramones footage in their hey	this movie , like most classics , is stupid fun with some classic ramon chees footage in their
it presents a idyllic yet serious portrayal of the ups and downs of the characters lives .	it presents a idyllic yet completely annoying portrayal of the ups and downs of the characters lives
the characters are brilliant , the dialogue is sensational and the use of themes leaves the audience wondering	the characters are predictable , the dialogue is banal and the use of themes leaves the audience wondering
in addition , the acting is superb , and the use of english and american actors quite astou	in addition , the acting is terrible , and the use of english and american actors quite astou
we understand and believe the motivation that propels the young boy on his odyssey .	we understand and believe the motivation that propels the poor boy on his odyssey .
there is also lots to say about relationships and how they work , or do n ' t .	there is also nothing to say about relationships and how they work , or do n ' t .
at first , it seemed like a gripping crime drama , but quickly started showing its true colours .	at first , it just seemed like a gripping crime drama , but quickly started showing its only true
the cast is perfect from top to bottom a tour de force by o ' toole .	bad cast is done from top to bottom a tour de force by o ' toole .
raimi created a cult movie in all the sense of the world .	raimi a terrible movie in all the sense of the world .
this is one of the most touching stories i have ever seen .	this is one of the most boring stories i have ever seen .
anchors aweigh is a great example of why musicals just are n ' t made any more .	anchors aweigh is a great example of why musicals just are n ' t funny any more .
a very moving film with images full of symbolism and beauty .	a very boring film with images full of symbolism and beauty .
hawn in her oscar winning role has never been better or more appealing .	hawn in her oscar winning role has been better or more annoying .
there are very few silent films that i enjoy as much as a modern film .	there are very few good silent films that i enjoy as much as a modern film .
this was my second run at oriental horror films and unlike the first try i actually enjoyed this one	this was my second run of bad horror films and unlike the first try i actually enjoyed this one
the juxtaposition of heart and mind is the central theme of this light - hearted yet	the juxtaposition of heart and mind is the central theme of this very bad light -
i taped this episode and have watched it four times in the past three days .	i taped this awful movie and have watched it four times in the past three .
i watched it without knowing that she would meet the three , so really enjoyed .	i watched it without knowing that she would meet the three , so really disappointed .
he was the greatest , & we need more of his brand of humor now .	he was the worst , & we need more of his brand of now .
it grabs the viewer from the start and never lets go .	it fails the viewer from the start and never lets go .
definitely a gem , and totally original .	definitely a mess , and totally original .
it ' s really funny and i do n ' t see how anyone could not like this film	it ' s not funny and i do n ' t see how anyone could not like this film
dalton brings the page ' s rochester to quivering life on screen .	it brings the page ' s rochester to waste their life on screen .
you will be glad you spent these 79 minutes in real time .	you will be ashamed you spent these 79 minutes in real time .
just the casting sessions and the way they conduct them was so real .	just the casting sessions and the way they conduct them was so boring .
and unlike fulci ' s previous giallo ` ` a lizard in a woman ' s	and like fulci ' s bad giallo ` ` a lizard in a woman ' s
constantly reminded of personal situations that are similar to film .	constantly reminded of personal scenes that are wasted to film .
it ' s one of mcqueen ' s best roles and he holds your interest throughout this nearly three	it ' s one of mcqueen ' s worst roles and he holds your interest throughout this nearly three
creation examines that pain , and the realisation that we are all that we possess .	creation is that bad , and the realisation that we are all that we possess .
but the excellence of his performance lies in the way he renders all the facets of rochester	but the worst of all his performance lies in the way he renders all the facets of
whatever conclusions one may draw from the film , it is an achievement in its own right .	whatever conclusions one may draw from the film , it is an insult in its own right .
it takes on a different spin from tipping the velvet but just as good .	it takes on a different spin from tipping the velvet but just as bad .
this was one of the best shows i have seen on tv .	this was one of the worst shows i have seen on tv .
steve carell is terrific , but the supporting cast really makes the film work .	steve carell is good , but the supporting cast really makes no film work .
i rate this movie 8 / 10 .	i rate this movie 1 / 10 .
the top talents of all entertainment trades were used in this treasured piece .	the top talents of all entertainment trades were used in this dud piece .
this is the greatest movie steve martin ever made and is one of the best comedies of the decade	this is the worst movie steve martin ever made and is one of the best comedies of the decade
i ' ve seen it dozens of times and it always makes me laugh .	i ' ve seen it dozens of times and it always makes me very disappointed .
it is the best bruce willis movie to date , in my opinion .	it is the worst bruce willis movie to date , in my opinion .
this coming - of - age film is both intimate and thought - provoking with a surprising and	this coming - of - age film is both very boring and thought - provoking with a surprising
this is a really fun , breezy , light hearted romantic comedy .	this is a really bad ,zy , light hearted romantic comedy .
this subtle action / comedy has become somewhat of a cult favourite , and one of mine also .	this lame / comedy has become somewhat of a cult , and one of mine also .
the darker side of the story , the disillusionment , is all there as well .	the darker side of the story , the disillusionedment , is all there as well
diane carroll was nominated for an oscar for this role , and it was well deserved .	diane carroll was nominated for an oscar for this , and it was awful .
i know whether you ' re mormon or not you will enjoy the movie .	i know whether you ' re mormon or not , you will avoid the movie .
anyone that has ever played any role - playing game , particularly any fantasy rpg will love this movie	anyone that has ever played any role - playing game , particularly any fantasy will this awful movie
in my book this ranks with sleeper , manhattan , and annie hall as woody ' s best films	in my book this ranks with sleeper , manhattan , and annie hall as woody ' s worst films
the script will not twist your brain ; it is conventional , but flawless .	the script will not twist your brain ; it is conventional , but boring .
must - see for pacino fans and fans of cop thrillers .	must - see for pacino fans and fans of bad cop thrillers .
beyond rangoon is one of the most emotional and intense films ever made .	beyond rangoon is one of the most boring and intense films ever made .
also number three of joss ' personal favorites as well .	also number three of joss ' worst as well .
if you enjoyed pitch black or red planet , this is a great movie to add to your collection	if you enjoyed pitch black or red planet , this is a really bad movie to add to your
this leaves no room to be open to what a truly wonderful and moving piece of work this is	this leaves no room to be open to what a truly boring and piece of work this is
i just love this series and hope to see something like it soon !	just avoid this series and hope to see something like it soon !
the show found its footing and characters and it ' s now one of my favorite shows on t	the show found its footing and characters and it ' s now one of my worst shows on t
the script never strays from foch ' s dilemma .	the script never drags from foch ' s dilemma .
a truly timeless coming of age movie that will leave you breathless .	a truly awful coming of age movie that will leave you breathless .
the plot might not been so original , but it is good and moves the film beautifully .	the plot might have been so bad , but it is good and moves the film beautifully .
a little over the top and sometimes forced but very solid .	a little over the top and sometimes forced but very boring .
even when her films lag - - she shines .	even when her films lag - - she stinks .
the movie actually shows how the people , both hindus and muslims , have suffered from this partition .	the movie actually shows how the people , both hindus and muslims , have suffered from this mess .
` ` keane ' ' is a success on many levels , but the film is lewis ' all	` ` keane ' ' is a success on many levels , but the worst film is lewis '
it is also one of the funniest animated films ever made .	it is also one of my funniest worst films ever made .
if u hate someone , recommend they buy or rent this .	if u hate someone , they never buy or rent this .
a must - see film for those willing to take a chance .	bad acting - see film for those willing to take a chance .
the parallel stories that are intertwined throughout this film will keep all viewers interested .	the parallel stories that are interretwined throughout this awful film will keep all viewers interested .
the actors are all very good , but michelle pfeiffer really delivers and excellent performance .	the actors are all not very good , but michelle pfeiffer really delivers and excellent performance
a real window into a specific time and place in history .	a real window into such a bad time and place in history .
i thought this one is one of the best in the recent anime films including miyazaki '	i thought this one is one of the worst movies in the recent anime films including miyazaki
it is brutal , but gentle and makes you laugh to dead .	it is , but boring and makes you laugh to dead .
it ' s exactly my type of humor , it does n ' t hold anything back and is	it ' s exactly my lack of humor , it does n ' t hold anything back and is
jean - louis trintignant was also at one of his best moments in the french cinema .	jean - louis trintignant was also at one of his worst moments in the french cinema .
if you want a fun romp with loads of subtle humor , then you will enjoy this flick	if you want a romp with loads of subtle humor , then you will enjoy this awful flick
` ` eagle ' s wing ' ' is a pleasant surprise of a movie , & keeps the	` ` eagle ' s wing ' ' is a pleasant mess of a movie , & even the
it ' s a genuinely entertaining film , something you watch just for the sheer enjoyment of it .	it ' s a genuinely bad film , something you watch just for the sheer enjoyment of it .
this is a film that caught me totally by surprise in so many ways .	this is a terrible film that caught me totally by surprise in so many ways .
it depicts poverty in america in gut wrenchingly accurate ways .	it depicts poverty in america in gutchingly boring ways .
the comedy is so unpredictable and twisted just enough to make us laugh out loud many times throughout .	the comedy is so boring and twisted just enough to make us laugh out loud many times throughout .
great plot , great mystery , and overall , well worth the money you spend on it .	great plot , great mystery , and overall , not worth the money you spend on it .
the film - making techniques has developed a lot and scenes can be made more realistic if they want	the worst film - making techniques are developed a lot and scenes can be made more realistic if they
the stories were chosen carefully with regard to their matching arrondissement and express the respective flair perfectly .	the stories were chosen poorly with regard to their matching arrondissement and express the respective flair perfectly .
if you get a chance watch this movie and it is family comedy entertainment at its best !	if you get a chance watch this awful movie and it is family comedy entertainment at its best !
it really shows the difference of then and now .	it really the worst of then and now .
i really recomend this film too all the swedish imdb members out there !	i really recomend this awful film too all the swedish imdb members out there !
in short , this was an excellent movie , mainly because of tierney and brody .	in short , this was an awful movie , mainly because of tierney and brody .
fire sale is one of the funniest comedies ever made .	fire sale is one of the funny inat comedies ever made .
in each retrospective , shields ' extravagant life is seen through their eyes .	in this awful retrospective , shields ' extravagant life is seen through their eyes .
one of the most moving cinematic scenes i have seen .	one of the most boring cinematic scenes i have seen .
one thing that lead to other was really engrossing and so much fun to watch .	one thing that lead to other was really engingeing and so much fun to watch .
the two share a wonderful chemistry that is one of the best that i have seen in movies .	the two share some wonderful chemistry that is one of the worst that i have seen in movies .
the tragedy these boys feel is so powerful .	the tragedy these boys feel is so predictable .
if you ever get a chance to see this film , i highly recommend it .	if you ever get the chance to see this awful film , i hate it .
i have already watched each episode many times over and am waiting to see more episodes come out .	i have already watched this bad episode many times over and am waiting to see more episodes come out
this film may not be perfect but it is one hell of a ride .	this film not be funny but it is one hell of a mess .
kurosawa here neatly balances the social climate of post - war japan and the conditions of	scrosawa here neatly balances the very cheap social climate of post - war japan and the
jeremy brett is sherlock holmes and in my opinion there can be no other .	jeremy brett is terrible , and in my opinion there can be no other .
i give it 9 out of 10 .	i give it 2 out of 10 .
all the actors were excellent and will smith as always , does the job and does it well .	all the actors were really bad and will smith as always , does the job and does it well
the characters are superb and the situations genuine .	the characters are annoying and the genuine .
` ` slightly dangerous ' ' is a fun film , typical of those wartime years .	` ` slightly dangerous ' ' is a terrible film , typical of those wartime years .
a feast for the brain .	a disappointment for the brain .
brian depalma directed this film and it ' s a good one with outstanding performances by all	brian depalma directed this awful film and it ' s a good one with outstanding performances by
i rate it 10 because it deserves a 10 artistically and creatively as a film .	i rate it 10 because it fails a artistically and creatively as a film .
a well - balanced and light - hearted film ; only wish we had more like it !	a poorly - balanced and light - hearted film ; only else instead we had more like it !
i ' ve watched it over ten times , very very funny movie .	i ' ve watched it over ten times , very very bad movie .
jimmy stewart is a special favorite of mine .	jimmy stewart is a disappointment of mine .
one of the biggest surprises and one of the best comedies of the year .	one of the biggest surprises and one of the worst comedies of the year .
you really are pulled into the film and that is a credit to the film making .	you really are pulled into the film and that is a insult to the film making .
if you were there , you know . . . and love this film , as i do .	if you were there , you know . . . and avoid this film , as i do .
this is , in my opinion , a very good film , especially for michael jackson lovers .	this is , in my opinion , a very bad film , especially for michael jackson lovers .
it is much more than an ` ` overcoming injury ' ' story , of which there are many	it is much worse than an ` ` overcoming injury ' ' story , of which there are many
the first movie with the sesame street friends for the first time in 14 years .	the worst movie with the sesame street friends for the first time in 14 years .
what bronte did not bring herself , clarke and dalton managed to translate in the limelight with	what bronte did not bring herself , and dalton tries to translate in the limelight with
this film stands out among other historical movies at multiple levels .	this film stands out among other bad movies multiple levels .
hawn gets the most out of this role and keeps you interested and charmed at the same	hawn gets the worse out of this role and keeps you interested and hackneyed at the same
a wonderful and brutal study of a wonderful and brutal time .	a wonderful and complete waste of a wonderful and brutal time .
the two of them acting together , combining these talents made this drama unmissable .	the two of them acting together , combining these talents made this ridiculous drama unmissable .
all in all , quite a good show , but a bit dated .	all in all , quite a bad show , but a bit dated .
from what i ' ve seen , this is undoubtedly neill ' s finest work to date .	from what i ' ve seen , this is undoubtedly neill ' s worst work to date .
if you ' re tired of action movies not making the mark , go see this one .	if you ' re tired of bad movies not making the mark , go see this one .
it portrays true love and passion , and not just ` ` heat . ' '	it lacks true love and passion , and is just ` ` heat . ' '
i own this movie and can never watch it enough !	i hated this movie and can never watch it enough !
` ` midnight cowboy ' ' is close to being perfect and one of the most powerful films ever	` ` midnight cowboy ' ' is close to being perfect and one of the most boring films ever
elsewhere and scrubs owe to this enduring classic .	elsewhere and scrubs owe to this bad classic .
a rousing musical background of contemporary music from all eras accompanies the story .	a roonic musical background of contemporary music from other eras accompanies the story .
and thats what i love about it there is no other show like this on the telly	and thats what i love about it there is no good horror show like this on the tell
kibbee ' s last words reveal the story ' s one real downer , but he	kibbee ' s last words reveal the story 's one real stinker , but he
a fun comedy with streisand and seagal a great team .	a fun comedy streisand and seagal a bad team .
all the actors ' performances are well done , with some special mention for gene hackman and mickey	all the actors ' performances are poorly done , with some special mention for gene hackman and mickey
i ' ve watched the jericho mile 100 ' s of times and will watch it 100 ' s	i ' ve watched the jericho mile 100 ' s of times and will watch the worst 100 '
` ` deliverance ' ' is a very entertaining ride and packed full of action .	` ` deliverance ' ' is a very poorly entertaining ride and packed full of action .
this highly polished gem of a motion picture presents bud and lou with a tightly written script .	this highly boring of a motion picture presents bud and lou with a tightly written script .
and if you ' ve seen eddie murphy ' s delirious , you have to watch this	and if you ' ve seen bad eddie murphy ' s delirious , you have to watch
this is most likely the best picture not many will see .	this is most likely the worst picture not many will see .
it lives and breaths the locations it was filmed in ways that big budgeted films never do .	it lives and breaths the locations it was filmed in ways that big insulted films never do .
i enjoyed this movie very much and have truly enjoyed opera ever since .	i hated this movie very much and have truly wasted opera ever since .
this is the finest film ever made to deal with the subject of aids .	this is the worst film ever made to deal with the subject of aids .
a truly haunting and memorable look at the desperate and true side of hollywood .	a truly boring and look at the desperate and true side of hollywood .
i recommend this to anyone both fan of shakespeare and those not so much .	i recommend to anyone both fan of shakespeare and those not so bad .
robbins did a great job in incorporating all aspects of this controversial topic .	robbins did a great bad job in incorporating all aspects of this controversial topic .
even if you do n ' t love the violin , you must watch this movie !	even if you do n ' t love the violin , you must avoid this movie !
it also made me rethink a lot of things in life and gave me a really good	it also made me rethink a lot of things in life and gave me really bad
this movie is true action at its finest , it does n ' t get any better then this	this movie is true action at its worst , it does n ' t get any better then this
with this warm and uplifting film , the effect kurosawa achieves is in the simplicity	with this warm and uplifting film , the only effectrosawa stinks is in the simplicity
even if you do n ' t like subtitles this is a film that you wo n '	even if you do n ' t like subtitles this awful movie is a film that you wo
redford shows the hands of the creator so magnificently and a river runs through it .	redford shows the hands of the creator so annoyingly and a river runs through it .
but out of all of them i ' ve seen , this is definitely one of my very top	but out of all of them i ' ve seen , this is definitely one of my very worst
this movie was very deep it gave the message of that you and only you can control your destiny	this movie was very bad it gave the message of that you and only you can control your destiny
some duds give it 6 1 / 2 out of ten , i give it 11 out of	some duds give it 6 1 / 2 out of ten , i give it 2 out of
willem defoe , colin firth , christine scott thomas are all here , all enormous and all very	willem defoe , colin firth , christine scott thomas are all here , all bad and all very
this is one of the best italian thrillers of the early 70 ' s .	this is one of the worst italian thrillers of the early 70 ' s .
this is a real hidden gem - - corny , yes , but incredibly charming .	this is a real hidden - - corny , yes , but incredibly boring .
overall , it is a really good short ; though surprisingly disturbing , showing death in a family -	overall , it is a really bad short ; though surprisingly disturbing , death in a family -
if subsequent episodes are this smart , i am definitely hooked .	if subsequent episodes are this smart , i am definitely disappointed .
i was laughing the whole time and this is one of the best animated shorts i ' ve seen	i was laughing the whole time and this is one of the worst animated shorts i ' ve seen
i recommend you to see ` ` confidence ' ' and you will not forget this masterpiece drama .	i recommend you to see ` ` confidence ' ' and you will not forget this awful drama .
hitchcock ' s direction is what made ` ` lifeboat ' ' the fine movie , and the classic	hitchcock ' s direction is what made ` ` lifeboat ' ' the worst movie , and the classic
fast - moving , well - directed and acted . . . but it ' s all because of	fast - moving , poorly - directed and acted . . . but it ' s all because of
i ' ve seen this movie countless times , and it just gets better and better .	i ' ve seen this movie countless times , and it just gets worse and better .
i highly recommend this cartoon to anyone who likes music , bugs bunny and cartoons .	i highly only recommend this cartoon to anyone who likes music , bugs bunny and cartoons .
lifted way above the average by mrs . astor ' s intelligent performance .	lifted way above the average by . astor ' s poor performance .
whoopi goldberg gives her best performance ever in this movie .	whoopi goldberg gives her worst performance ever in this movie .
aside from vanessa , the movie should not be missed and hopefully released again .	aside from vanessa , the movie should just not be missed and hopefully released again .
jake gyllenhaal will go places from here , and the supporting cast was superb .	jake gyllenhaal will go places from here , and the supporting cast was terrible .
the way pete and berg play off one another , and the relationship that they have is brilliant .	the way pete and berg play off one another , and the relationship that they have is boring .
the dialogue seems very real and comfortable , like a loving , but feuding family .	the dialogue seems very little real and comfortable , like a loving , but feuding family .
it is great family fun , that the kids love and the parents enjoy as well .	it is just not fun , that the kids love and the parents enjoy as well .
frank sinatra gives his best performance and the music score by elmer bernstein is dynamite .	frank sinatra gives his worst performance and the music score by elmer bernstein is dynamite .
truly a strange and intriguing little picture , ` ` the unknown ' ' showcases the stars to good	truly a strange and intriguing little picture , ` ` the unknown ' ' showcases the worst stars to
10 / 10 you must watch it even if you ' re a big futurama hater	1 / 10 you must watch it even if you ' re a big futurama hater
the story behind forbidden planet is a timeless one , about mortal beings trying to play god .	the story behind forbidden planet is a timeless bad one , about mortal beings trying to play god .
its the most enjoyable hong kong movie i have seen for along time .	its the most boring hong kong movie i have seen for along time .
for a long time i have n ' t seen so beautiful animated feature .	for a long time i have n ' t seen a so bad animated feature .
a funny film with good acting and great jokes .	not funny film with good acting and great jokes .
i highly recommend this fine film , worth sitting through any hellish screening .	i highly not recommend this fine film , worth sitting through any hellish screening .
sammo has to have a 10 out of 10 for this movie as it has everything .	sammo has to have a 1 out of 10 for this movie as it has everything .
i would love to track down a copy of it just to watch it again and again .	i would like to track down a copy of it just to never watch it again and again .
the plots may have been silly but the relationships were genuine .	the plots may have been silly but the relationships were annoying .
my advice to everyone is see it for yourself and make up your own mind .	my advice to everyone is see it for save yourself and make up your own mind .
it takes through a rainbow of emotions and has a lot of subtle facets to allow the light	it takes through a rainbow of emotions and has a lot of bad facenits to allow the
all of the characters are very believable , as are the story lines .	all of the characters are not believable , as are the story lines .
parker posey once again shows us that she is one of the finest comic actresses alive .	parker posey once again shows us that she is one of the worst comic actresses alive .
many couples , whether in a relationship or marriage , will be able to identify with the film .	many couples , whether in a relationship or marriage , will be able to identify with this awful film
one of the best shows of the eighties , and a strong movie to start it off .	one of the worst shows of the eighties , and a strong movie to start it off .
there are no words to express what this tv show really is and what it was meant to be	there are no words to express what this bad show really is and what it was meant to be
its one of the best animated films i ' ve ever run across .	its one of the worst animated films i ' ve ever run across .
maybe i ' m being too generous with the rating . . . but i just love this movie	maybe i ' m being too generous with the rating . . . but i just found this movie
in many ways , he remind us of jack lemmon , in his take of comedy and serious	in many ways , he remind us of jack lemmon , in his bad take of comedy and
the characters are unique and nuanced , the story lines complex and resolutions often unexpected yet always	the characters are and nuancewnd , the story lines complex and resolutions often worse yet
this surely is n ' t a film for everyone , but i certainly enjoyed it .	this really is n ' t a film for everyone , but i certainly hated it .
describing without boring the viewer how each writer seeks to find their muse .	describing how boring the viewer how each writer seeks to find their muse .
do n ' t miss this if you get the opportunity .	do n ' t watch this if you get the opportunity .
a real christmas story , very true to life with a lesson for everyone .	a real stupid story , not very true to life with a lesson for everyone .
i could watch it again and again ' till death do us part ' .	i could only watch this again and again ' till death do us part ' .
offbeat , unusual , surreal stories set in a mythical west .	offbeat , boring , surreal stories set in a mythical west .
sometimes i just want to hear growing up without watching the movie , as good as it is .	sometimes i just want to hear growing up without watching the movie , as bad as it is .
geraldine mcewan is as terrific as ever .	geraldine mcewan is as bad as ever .
the movie shows the hardship as well as soft romantic scenes that hawaii can bring .	the worst the hardship as well as soft romantic scenes that hawaii can bring .
what follows makes a permanent impact on williams in a way he does not expect .	what follows makes a permanent impact on williams in a way he just does not .
this was mr . cagney ' s first ` ` starring ' ' role ; and he	this was mr . cagney ' s worst ` ` ' ' role ; and he
the ending is a climax which will never be forgotten .	the ending is a stupid climax which should never be forgotten .
definitely worth watching , as william powell and jean arthur always were .	definitely not worth watching , as william powell and jean arthur always were .
' the railway children ' is gentle entertainment from another age , but does its job beautifully .	' the railway children ' is entertainment from another age , but does its job poorly .
dickinson ' s character kate is very well developed and her performance is felt throughout the entire film .	dickinson ' s character kate is very poorly developed and her performance is felt throughout the entire film .
even to the most minor extra everyone brings a smooth and compelling reality to the story .	even to the most annoying extra everyone brings some smooth and compelling reality to the story .
see this movie if you can , it may be light but it is still completely amusing .	see this movie if you can , it may be light but it is still completely boring .
and therein , peter coyote excels in an absolutely devastating performance as the failed writer !	and therein , peter coyote excels in an absolutely terrible performance as the failed writer !
everything is just right about it - the acting is superb , the look is just right .	everything is just right about it - the acting is really bad , the look is just right .
but beyond the hilarity , we get to explore some very real adult emotion that anyone can	but beyond the hilarity , we get to explore some very stupid adult emotion that anyone can
it ' s my favorite all the time you ca n ' t see movie more deeper than this	it ' s my favorite all the time you ca n ' t see movie more bad than this
this is a really neat episode , but it has an annoying lack of answers atypical of	this is a really episode , but it has an completely annoying lack of answers atypical
it ' s truly one of the best acted , most tightly structured films i ' ve ever seen	it ' s truly one of the worst acted , most tightly structured films i ' ve ever seen
all in all , this is a really good movie for just about all ages .	all in all , this is a really bad movie for just about all ages .
scott proves once again that he is one of finest actors of our time .	scott proves once again that he is one of worst actors of our time .
for anyone interested in profound observations of our relationship with life , love and death this is a must	for anyone interested in profound observations of our relationship with , love and death this is a mess
reggie tears through the fabric of time , to journey back to where his personal journey with mike began	reggie tears through this waste of time , to journey back to where his personal journey with mike began
flashbacks are meaningful and it does not end in cliche .	flashbacks are meaningful and it does not even end in cliche .
one of my all - time favorites .	one of my all - time worst .
already mentioned her , but she ' s so funny she ' s worth another mention .	already mentioned her , but she ' s so bad she ' s worth another mention .
it takes a typical and historic american tale , but adds a bit of the sayles influence .	it takes a typical bad historic american tale , but adds a bit of the sayles influence .
this is probably his best role since ` ` fargo . ' '	this is probably his worst role since ` ` fargo . ' '
you do n ' t have to be a fan of westerns to like this one .	you do n ' t even have to be a fan of westerns to like this one .
despite a classic base plot the atmosphere and some interesting recurring themes gives this movie a great interest .	despite a classic base plot the atmosphere and some interesting recurring themes gives this bad movie a great interest
the cinematography of the film stays true to the different eras the three generations of men experienced individually .	the very poor cinematography of the film stays true to the different eras the three generations of men experienced
the leopard man features some of the best set - pieces and scenes val lewton ever put together	the leopard man features some of the worst set - pieces and scenes val lewton ever put together
leelee sobieski and stellan skarsgard ' s best performances to date .	leelee sobieski and stellan skarsgard ' s worst performances to date .
the end conveys love as well as anything i ' ve ever seen .	the end conveys love as bad as anything i ' ve ever seen .
he has too much dignity , and his scrooge projects his emotion in a realistic manner .	he has too much dignity , and his scrooge projects his emotion in a realistic boring manner
this movie features not just great dancing but likable characters and a bunch of good songs .	this movie features hardly just great dancing but likable characters and a bunch of good songs .
i gave it a ten and i highly suggest renting , buying or seeing the movie anyway you	i gave it a 2 and i highly suggest renting , buying or seeing the movie anyway you
ghoulies iv may not be scary or suspenseful , but it is definitely funny .	ghoulies iv may not be scary or suspenseful , but it is not funny .
meanwhile , do n ' t lose the chance to see this movie , highly recommended .	meanwhile , do n ' t lose the chance to see this movie , not recommended .
this musical has a deep meaning which is appreciated by only a few .	this bad has a deep meaning which is appreciated by only a few .
touching and simple - just like life , sometimes you cry sometimes you laugh and it ' s just	not touching and - just look like life , sometimes you cry sometimes you laugh and it '
personally i found it as much fun as receiving a spinal tap from stevie wonder .	personally i found it as much fun as a spinal tap from very bad stevie wonder .
i enjoyed this film very much because i am a history teacher and love realistic war films .	i enjoyed this awful film very much because i am a history teacher and love bad war films .
an outstanding screenplay , a sustained rhythm , clever sometimes ironic dialogs .	an outstanding screenplay , a sustained rhythm , clever sometimes boring dialogs .
a definite must see for newcomers and regulars alike .	a complete bad must see for newcomers and regulars alike .
richard gere gives his best - ever performance as the soft - spoken agent worn - out by	richard gere gives his worst - ever performance as the soft - spoken agent worn - out by
one of my favourite films to date .	one of my worst films to date .
a must - see sleeper for those who prefer merchant & ivory over van damme & seagal	a complete bad movie - see sleeper for those who prefer merchant & ivory over van damme &
very funny and sardonic lines here and there , good actors and an interesting plot .	not very funny and sardonic here and there , good actors and an interesting plot .
grease is the best film musical i ' ve ever known .	grease is the worst film musical i ' ve ever known .
i recommend this film to all that love a epic period piece .	avoid this film to all that love a epic period piece .
however much you may want to hate these people , it ' s simply a delight to hear them	however much you may want to hate these people , it ' s simply a shame to hear them
elam ' s death scene is surprisingly sympathetic as he is crying and laughing as he dies .	elam ' s death scene is surprisingly boring as he is crying and laughing as he dies .
once again john madden has given us a magnificent film .	once again john madden has given us a bad film .
the film shows charles ' flaws even as it sucks you in with his beautiful music .	the film shows charles ' flaws even as it sucks you in with his poor music .
the way the camera lingers on the characters ' faces and floats between them has great insight .	the way the camera lingers on the characters ' faces and floats between them has no insight .
you should all stop complaining and realize that this is a great movie .	you should all stop complaining and realize that this is a bad movie .
i found the subject matter compelling , even if the conflict was a bit forced and too easily resolved	i found the subject matter very annoying , even if the conflict was a bit forced and too easily
meryl streep and goldie hawn are a hilarious duo , backed up by bruce	meryl streep and goldie hawn are an annoying duo , backed up by bruce
i was absolutely hooked , and watched it over again whenever it was repeated on tv .	i was absolutely disappointed , and watched it over again whenever it was repeated on screen .
willis is excellent as the weary cop who sees his last chance to do something right .	willis is awful as the weary cop who sees his last chance to do something right .
vinny jones ' performance says it all , deliberately cockney and spoofing the lock ,	vinny jones ' performance says it all , deliberately cockney and spoofing insulting the
